"--are	
"melissa officinali	"melissa officinalis
/ s	/ s
/ shrubland	/ shrublands
/ yellow marking	/ yellow markings
1ft	1ft
1st	1st
2in	2in
5cm	5cm
6in	6in
abaxially glabrous	abaxially glabrous
abdominal segment	abdominal segment
abdominal tube	abdominal tubes
abilities	ability
ability	ability
abiotic disorder	abiotic disorders
absence	absence
abundance	abundance
abundances	abundance
abutilon theophrasti	abutilon theophrasti
acanthium	acanthium
acantho	acanthos
acarapi	acarapis
acarapi woodi	acarapis woodi
acarapis woodi	acarapis woodi
acari	acari
acclimation stage	acclimation stage
accompaniment	accompaniment
account log	account logs
acer	acer
acer campestre	acer campestre
acer cappadocicum	acer cappadocicum
acer grandidentatum	acer grandidentatum
acer lobelii	acer lobelii
acer negundo	acer negundo
acer nigrum	acer nigrum
acer platanoide	acer platanoides
acer saccharum	acer saccharum
acer truncatum	acer truncatum
achene	achenes	achene
achillea millefolium	achillea millefolium
acid	acids	acid
acid cis-cinnamic roles	acid cis-cinnamic role
acid content	acid content
acid derivative	acid derivatives
acid mine drainage	acid mine drainage
acid rain	acid rain
acid soil condition	acid soil conditions
acid-lover	acid-lovers
acidic gas	acidic gas
acidification	acidification
acidity	acidity
acids	acid
act	acts
action firethorn	action firethorn
active growth	active growth
adding fertility	adding fertility
adding nitrogen	adding nitrogen
addition	addition
additional common name	additional common names
additive	additive
admin	admin
administrator	administrators
adult	adult	adults
adult female scale	adult female scales
adult form	adult form
adult gypsy moth	adult gypsy moths
adult sawfly	adult sawflies
adult silverleaf	adult silverleaf
advent	advent
aeration	aeration
aerator	aerator
aerator run	aerator run
aerial bulblet	aerial bulblets
aerial part	aerial parts
aerobic decomposition	aerobic decomposition
aesthetic characteristic	aesthetic characteristics
aesthetic damage	aesthetic damage
affected tree	affected trees
affecting dna molecule	affecting dna molecules
affecting maple disease problem	disease problems affecting maples
affecting people	affecting people
affecting people hundreds	affecting people hundreds
aftertaste	aftertaste
age class	age classes
agency	agencies
agent	agents	agent
agermona	agermone
aggressive	aggressive
aggressive herbicide	aggressive herbicides
aggressive nature	aggressive nature
aggressive plant	aggressive plant
aggressive spread	aggressive spread
aggressive weed	aggressive weeds
agitation	agitation
agricultural area	agricultural areas
agricultural byproduct	agricultural byproduct
agricultural commodity	agricultural commodities
agricultural context	agricultural context
agricultural field	agricultural fields
agricultural pest	agricultural pest	agricultural pests
agricultural pest insect	agricultural pest insects
agricultural region	agricultural regions
agricultural scenario	agricultural scenarios
agriculture	agriculture
agriculture industry	agriculture industries
agriculture n.	agriculture n.
agriculture n.a.cobb	agriculture n.
agriculture pests	agriculture pest
agriculture plant hardiness zone	agriculture plant hardiness zones
agriculture serious pest	serious pests for agriculture
agricultures	agriculture
agrimonia	agrimonia
agrimonia eupatoria	agrimonia eupatoria
agrimony	agrimony
agronomy	agronomy
ailanthu	ailanthus
ailanthus	ailanthus
ailanthus altissima	ailanthus altissima
ailanthus altissimum	ailanthus altissima
ailanthus eradication	ailanthus eradication
ailment	ailments
air circulation	air circulation
air retention	air retention
air temperature	air temperature
ajuga reptan	ajuga reptans
alae	alae
alaska	alaska
alaska flowers	alaska flower
alaska state flower	state flower of alaska
albania	albania
alchemilla	alchemilla
alchemilla molli	alchemilla mollis
aldrichi	aldrichi
algal body	algal bodies
alimentary canal	alimentary canal
alkaloid	alkaloids
alkaloids kill worm	alkaloids kill worms
allelochemical	allelochemicals
allelopathic chemical	allelopathic chemicals
allelopathic trait	allelopathic trait
allelopathy	allelopathy
allergen protein	allergen protein
allergic mucus problem	allergic mucus problems
allergic reaction	allergic reaction
allergy	allergies
allergy problem	allergy problems
alley	alleys
allium	allium
allium vineala	allium vineale
allium vineale	allium vineale
allowing clover	allowing clover
allowing fruit	allowing fruits
almond-like odor	almond-like odor
alpestri	alpestris
alternative management option	alternative management options
alternative name	alternative names
alternative predator	alternative predators
altissima	altissima
altissimum	altissima
amaranthaceae	amaranthaceae
amb	amb
ambrosia	ambrosia
amelanchier	amelanchier
amelanchier lamarckii	amelanchier lamarckii
amelanchier ovali	amelanchier ovalis
amenorrhea	amenorrhea
america	americas
american	americans
amino acid	amino acids
ammonia	ammonia
ammonium carbonate mix	ammonium carbonate mix
ammonium salt	ammonium salts
amur honeysuckle	amur honeysuckle
amur honeysuckle monoculture	monoculture of amur honeysuckle
amur river	amur river
amygdalin	amygdalin
anaerobic	anaerobic
anamorph	anamorph
anatomy	anatomy
anemia	anemia
anglo saxon	anglo saxons
angular notching	angular notching
angular solomon	angular solomon
angular stalk	angular stalks
animal	animals
anisopliae	anisopliae
ant species	ant species
antagonistic organism	antagonistic organisms
antanna	antannae
antannae	antannae
antarctica	antarctica
antennal form	antennal forms
anthelmintic	anthelmintic
anthocyanin	anthocyanins
anthracnose	anthracnose
anthrocorid bug	anthrocorid bugs
anti-allergenic compound	anti-allergenic compounds
anti-inflammatory	anti-inflammatory
anti-inflammatory property	anti-inflammatory properties
anti-oxidant protection	anti-oxidant protection
anti-slavery protest	anti-slavery protest
antibacterial	antibacterial
antibacterial property	antibacterial properties
antidote	antidote
antifeedant	antifeedant
antioxidant	antioxidants	antioxidant
antioxidant property	antioxidant properties
antiviral property	antiviral properties
apex	apex
aphidoideum	aphidoidea
aphis gossypii	aphis gossypii
apical bud	apical buds
apical dominance	apical dominance
apical inflorescence	apical inflorescence
apical meristem	apical meristem
apical tip	apical tip
apocrita	apocrita
apomict	apomicts
apomixi	apomixis
apophallation	apophallation
aposematic display	aposematic displays
app	app
app.	app
appalachian mountain	appalachian mountains
appendage	appendages
application	applications
application purpose	application purposes
applications	application
applicator	applicator
applying mulch	applying mulch
appresoria	appresoria
appresorium formation	appresorium formation
appresorium formation.	appresorium formation
appresoron	appresoria
apterous female	apterous females	apterous female
apterous young	apterous young
aquaponics w	aquaponics w
aquatic beetle	aquatic beetles
aquatic family	aquatic families
aquatic life	aquatic life
aquatic pollution	aquatic pollution
arborea	arborea
arborea plant	arborea plants
arborecent	arborecent
arborvitae	arborvitae
arctic circle	arctic circle
area	areas
argemonia	argemonia
arizona	arizona
armillaria fungus attack	armillaria fungus attacks
armyworm	armyworm
armyworm beet ranges	armyworm beet range
aromatherapy	aromatherapy
arquebusade water	arquebusade water
arrangement	arrangements
art form	art form
artemisia vulgari	artemisia vulgaris
arthropod	arthropods
arthropod host	arthropod hosts
arthropod pest	arthropod pests
arthropoda	arthropoda
arthropodum	arthropoda
article	articles
artificial dispersal	artificial dispersal
artificial environment	artificial environment
artificial fence	artificial fences
artificial fertiliser	artificial fertilisers
artificial nitrogen fertiliser	artificial nitrogen fertilisers
artificial trail	artificial trails
asarum canadensi	asarum canadensis
asclepia	asclepias
asclepia lanceolata	asclepias lanceolata
asclepias lanceolata	asclepias lanceolata
ascomycete	ascomycetes
asexual	asexual
asexual dormant body	asexual dormant body
asexual infections	asexual infection
asexual one	asexual ones
asexual reproduction	asexual reproduction
asexual seed production	asexual seed production
asexual spore infection process	infection process of asexual spores
asexual spore production	asexual spore production
asexually reproducing form	asexually reproducing form
ash-leaved maple	ash-leaved maple
ashleaf maple	ashleaf maple
asiatic tearthumb	asiatic tearthumb
asparagin	asparagin
aspect	aspect
assignment	assignments
assisting wind dispersal	assisting wind dispersal
association	associations
aster leafhopper	aster leafhopper
asteraceae	asteraceae
asthma	asthma
astringent	astringent
atlantic	atlantic
attack	attacks
attack garden plant	attack garden plants
attack orchard tree	attack orchard trees
attained variety status	attained variety status
attempt	attempts
attractant flower	attractant flowers
attracting plant	attracting plant
auchenorryncha	auchenorryncha
august close	august close
australia	australia
autoimmune disease	autoimmune diseases
auxin	auxin
available light	available light
awaiting import	awaiting import
axe	axe
axil	axil	axils
axillary branch	axillary branches
axillary cyme	axillary cymes
ayurveda	ayurveda
ayurvedic	ayurvedic
ayurvedic writing	ayurvedic writings
azadirachtin	azadirachtin
bacillu popilliae	bacillus popilliae
bacillus	bacillus
bacillus popilliae	bacillus popilliae
backho	backhoes
backhoe	backhoes
backswimmer	backswimmers
bacterial disease	bacterial diseases
bacterial pathogenicity factor	bacterial pathogenicity factors
bacterial plant pathogen	bacterial plant pathogens
bacterium	bacteria
bad crotching	bad crotching
bag	bags
bagworm	bagworm
balkan peninsula	balkan peninsula
balm	balm
band bridge	band bridges
bangladesh	bangladesh
bank	banks
barbarea vulgari	barbarea vulgaris
barbecueing	barbecueing
barberry	barberry
barrier	barriers
barrier plant	barrier plants
barriers paulownia tomentosum	barriers paulownia tomentosa
bartramiana	bartramiana
basal bark application	basal bark application
basal bract	basal bract
basal calyx	basal calyx
basal clump	basal clump
basal cutting	basal cuttings
basal lobe	basal lobes
basal rosette	basal rosette
basal segment	basal segments	basal segment
basal sucker	basal suckers
basally branched	basally branched
base tooth	base teeth
basidiomycete	basidiomycetes
basil	basil
basil cultivar	basil cultivars
basilicum	basilicum
bassiana	bassiana
basswood	basswood
battle field	battle field
battle wound	battle wounds
bc-63bc	bc-63bc
bce	bce
bean / s	bean/s	bean / s
bean/s	bean/s
bearer	bearers
bearing apical microsporangia	bearing apical microsporangia
bearing fruit	bearing fruit
bearing shoot	bearing shoots
bearing variety	bearing varieties
beauveria bassiana	beauveria bassiana
bee specie	bee species
bee species	bee species
beech-maple forest type	beech-maple forest type
beet / s	beet/s	beet / s
beet armyworm	beet armyworm
beet armyworm host range	host range of the beet armyworm
beet hosting	beet host
beet/s	beet/s
beetle	beetles	beetle
beetle larvae pupate	beetle larvae pupate
beetle lifecycle principal feeding stage	principal feeding stage of the beetle lifecycle
beetle specie	beetle species
beetle species	beetle species
beggartick	beggartick
beginner gardener	beginner gardeners
behavioural mimicry	behavioural mimicry
being cut	being cut
being phloem-feeder	being phloem-feeders
being sown	being sown
being vertical	being vertical
beltsville	beltsville
benefit-to-cost ratio	benefit-to-cost ratio
benomyl	benomyl
benomyl fungicide prior	benomyl fungicide prior
berberi	berberis
berberis thunbergii	berberis thunbergii
berberis tus	berberis thunbergii
berry	berry	berries
berry-like pome	berry-like pome
best action	best action
best result	best results
beta-sitosterol	beta-sitosterol
bha	bha
bht	bht
bicorni	bicornis
biennial	biennial
biennial herb native	biennial herb native
biennial plant	biennial plant	biennial plants
biennial plant|biennial	biennial plant
biennial specimen	biennial specimens
big lawn treatment	big lawn treatment
bigtooth maple	bigtooth maple
bile flow	bile flow
binomial name	binomial name
biocontrol	biocontrol	biocontrols
biocontrol agent	biocontrol agent	biocontrol agents
biocontrol program return	biocontrol program returns
biodiversity	biodiversity
biodiversity furthers health	biodiversity furthers health
biological agent	biological agents
biological control	biological control	biological controls
biological control agent	biological control agents
biological diversity	biological diversity
biological gardening approach	biological gardening approach
biological insecticide	biological insecticide
biological pest control	biological pest control
biological remedy	biological remedy
biology	biology
biotroph	biotrophs
bipinnate	bipinnate
bipinnatifid	bipinnatifid
birch	birch
bird	birds
bird dropping	bird droppings
bird specie	bird species
bird species	bird species
birth rate	birth rate
bite	bites
biting section	biting sections
bittercre	bittercress
bittercres	bittercress
black walnut	black walnut
black-and-white	black-and-white
blackhawk	blackhawk
blade	blades
blight symptom	blight symptoms
blister beetle / s	blister beetle/s
blister beetle/s	blister beetle/s
blotching	blotching
blue vervain	blue vervain
blue-green	blue-green
blueberry	blueberry
body	bodies
body cavity	body cavity
bok choy	bok choy
bokbunja manufacturer	manufacturers of bokbunja
bone meal / compost mix	bone meal/compost mix
bone meal/compost mix	bone meal/compost mix
book cross-links	book cross-links
bootjack	bootjack
border perennial	border perennial
borer attack	borer attacks
borer-infected vine	borer-infected vines
boron	boron
botanical name	botanical name
botanical source	botanical sources
bouncing bet	bouncing bet
bowel	bowels
bowling alley	bowling alleys
boxelder	boxelder
boxelder bug	boxelder bug
boxelder maple	boxelder maple
branch	branches
branchlet	branchlets
brand name	brand names
branding	brand
brandywine	brandywine
brassica	brassicas
brassicaceae	brassicaceae
breakdown product	breakdown product	breakdown products
breath spiraea	breath spiraea
breathing difficulty	breathing difficulties
brick-red spot	brick-red spots
bridge	bridges
broad-spectrum herbicide	broad-spectrum herbicide
broadleaf plant	broadleaf plants
broadleaf plantain	broadleaf plantain
brown-tail	brown-tail
brunnera macrophylla	brunnera macrophylla
brusher	brusher
bryophyte	bryophytes
buckeye	buckeyes
buckwheat family	buckwheat family
bud	buds	bud
bug	bugs
bugleherb	bugleherb
bugleweed	bugleweed
bulb	bulb
bulb nematode	bulb nematode
bulbil	bulbils
bulbous abdomen	bulbous abdomen
bulgaria east	bulgaria east
bulk laxative	bulk laxative
bur-like seed	bur-like seeds
buried seed	buried seed
burned area	burned areas
burnt potato chip	burnt potato chips
burrobush	burrobush
burying beetle	burying beetles
bushine	bushiness
bushines	bushiness
business owner	business owners
butterfly pupa	butterfly pupae
butternut	butternut
butterprint	butterprint
buttonlike cluster	buttonlike clusters
buttonweed	buttonweed
buxu	buxus
buxu semperviren	buxus sempervirens
buxus semperviren	buxus sempervirens
by-product	by-product
by-product obtained	by-product obtained
cabinetry timber	cabinetry timber
calcareous soil	calcareous soils
calcium	calcium
calcium absorption	calcium absorption
california	california
california agriculture industry	california agriculture industries
california boxelder	california boxelder
called adhesin	called adhesins
called bacteriocyte	called bacteriocytes
called canada root	called canada root
called cleistothecia fruiting body	fruiting bodies called cleistothecia
called conidia	called conidia
called dandyblend	called dandyblend
called hemibiotroph	called hemibiotrophs
called manitoba maple	called manitoba maple
called ocrea	called ocreas
called satyrion	called satyrion
called sclerite numerous plate	numerous plates called sclerites
called spiracle	called spiracles
callosobruchu	callosobruchus
callosobruchu maculatu	callosobruchus maculatus
callosobruchus maculatus	callosobruchus maculatus
calycanthu	calycanthus
calycanthu floridu	calycanthus floridus
calycanthus floridus	calycanthus floridus
calyx	calyx
cambial tissue	cambial tissue
cambium	cambium
campesterol	campesterol
campodeiform	campodeiform
campsite	campsites	campsite
canadensi	canadensis
cancer treatment	cancer treatment
cancerous ulcer	cancerous ulcers
cankerwort	cankerwort
canopy	canopy
cap raspberry	cap raspberry
capitula	capitula
capitulum	capitula
cappadocian maple	cappadocian maple
capsule	capsules
carabidae	carabidae
carbon dioxide	carbon dioxide
carbon source	carbon source
cardiac palpitation	cardiac palpitation
cardiovascular complaint	cardiovascular complaints
care organic pesticide	care organic pesticides
caribbean island	caribbean islands
carnation family	carnation family
carnivorous plant species	species of carnivorous plant
carnosol	carnosol
carolina hemlock tree	carolina hemlock trees
carotenoid content	carotenoid content
carpel	carpel
carpetweed	carpetweed
carrot / s	carrot/s
carrot/s	carrot/s
cartoon	cartoons
caryophyllaceae	caryophyllaceae
case	cases
cassava	cassava
cassinoide	cassinoides
casting handful	casting handfuls
catalog	catalogs
category	categories
caterpillar growth	caterpillar growth
caterpillar sociality	caterpillar sociality
caterpillar triggers abortion	caterpillar triggers abortion
caterpillar-like larva	caterpillar-like larvae
caterpillars	caterpillar
caterpillars deposit exploratory trail	caterpillars deposit exploratory trails
caterpillars move	caterpillars move
catsear	catsear	catsears
catsear flowering stem	catsear flowering stems
catterpiller	catterpillers
caucasu mountain	caucasus mountains
caucasus mountain	caucasus mountains
cauda	cauda
cauline	cauline
cause disease	cause diseases	cause disease
cause problem	cause problems
cause root damage	cause root damage
cause rot	cause rots
causing hay fever	causing hay fever
cave-dwelling specie	cave-dwelling species
cave-dwelling species	cave-dwelling species
celandine poppy	celandine poppy
cell	cells
cell wall	cell walls
cellpack	cellpack
cellular respiration	cellular respiration
cellulose	cellulose
celsius	celsius
certain specie	certain species
certain species	certain species
chamomila	chamomile
chamomile	chamomile
chamomile / pineapple aroma	chamomile/pineapple aroma
chamomile establishments	chamomile establishment
chamomile lawn establishment	establishment of a chamomile lawn
chamomile/pineapple aroma	chamomile/pineapple aroma
change	changes
characteristic	characteristics
characteristic hovering	characteristic hovering
characteristic large size	characteristic large size
chemical	chemicals
chemical composition	chemical composition
chemical control	chemical control
chemical input	chemical inputs
chemical method	chemical methods
chemical pesticide program	chemical pesticide program
chemical pollutant	chemical pollutants
chemical spraying	chemical spraying
chemical trace	chemical traces
chemical trial	chemical trials
cherry-laurel	cherry-laurel
chest rub	chest rub
chestnut borer attack	chestnut borer attacks
chesty cold	chesty colds
chicken pox	chicken pox
chigger flower	chigger flower
chiggerflower	chiggerflower
chip	chips
chipmunk	chipmunks
chitin	chitin
chlamydospore	chlamydospores
chlorosi	chlorosis
chokecherry	chokecherry
choy	choy
chromosome	chromosomes
chrysomelidae	chrysomelidae
circular hard scale	circular hard scales
circular muscle	circular muscles
circulatory	circulatory
circulatory system	circulatory system
cis-cinnamic acid	cis-cinnamic acid
cis-cinnamic acid potential role	potential role of cis-cinnamic acid
citral	citral
citronella oil	citronella oil
citronellol	citronellol
class	classes
class arachnida	class arachnida
class assignment	class assignments
clavate sub-form	sub-forms of clavate
claytonia	claytonia
clearweed	clearweed
cleistothecia	cleistothecia
cleistothecon	cleistothecia
climax tree species	species of climax trees
climb	climb
clinical trial	clinical trials
clove-like flavour	clove-like flavour
clover	clover
clump	clump
clumpfoot cabbage	clumpfoot cabbage
cluster	clusters
cm diameter	cm diameter
cm long	cm long
cm raceme	cm racemes
cm wide	cm wide
cm wing	cm wing
coarse texture	coarse texture
coat protein	coat protein
coccoon	coccoons
coelomate animal	coelomate animals
cole crop	cole crops
coleoptera	coleoptera
coleoptus	coleoptera
collagen	collagen
collecting seed	collecting seed
collective agriculture communist-style	communist-style collective agriculture
colonial habit	colonial habit
colonization	colonization
colony	colony
color	colors
colorant	colorants
colouration	colouration
coltsfoot	coltsfoot
columnare	columnare
commemoration	commemorations
commercial preparation	commercial preparations
commercial production	commercial production
commercial propagation method	commercial propagation methods
commercial website	commercial websites
commodity	commodities
common biocontrol agent	common biocontrol agents
common bugle	common bugle
common chickweed	common chickweed
common lilac	common lilac
common name	common names
common ragweed	common ragweed
common ragwort	common ragwort
common spacing	common spacing
common stalk borer	common stalk borer
common yarrow	common yarrow
communal nest	communal nests
community-wide mosquito control program	community-wide mosquito control programs
compaction	compaction
competitive plant	competitive plant
complaint	complaints
complication	complication
composite	composites
composite family	composite family
compound	compound
compound eye	compound eyes
comprehensive study	comprehensive studies
concentrations	concentration
condition	conditions
conicle	conicles
conidia spore land	conidia spore lands
conifer	conifer
conjunctivitu	conjunctivitus
conjunctivitus	conjunctivitus
connecticut	connecticut
conscious organic gardener	conscious organic gardener
conservationist	conservationists
consideration	consideration
consition	consitions
conspicuous ribbon-like	conspicuous ribbon-like
conspicuous silk trail	conspicuous silk trails
conspicuous spiny-winged	conspicuous spiny-winged
constructing house	constructing houses
construction	construction
consumer protection directorate	consumer protection directorate
containing livestock	containing livestock
continual annoyance	continual annoyance
continuous layer	continuous layer
continuous process	continuous process
contition	contitions
contraceptive	contraceptive
contributing factor	contributing factors
contributor	contributors
control	controls
control agent	control agents
control program	control programs
control strategy	control strategy
controlling ailanthu	controlling ailanthus
controlling ailanthus	controlling ailanthus
controlling ragweed	controlling ragweed
controlling runoff	controlling runoff
convective heat loss	convective heat loss
conventional home garden	conventional home gardening
conventional home gardening	conventional home gardening
converting pair	converting pairs
convulsant	convulsant
cooking purpose	cooking purposes
cool season grass	cool season grasses
cool-season	cool-season
cool-season crop	cool-season crop
coolwort	coolwort
coordination	coordination
copal tree	copal tree
copious production	copious production
copious straight spine	copious straight spines
copious sucker	copious suckers
copious thorn	copious thorns
coppertina	coppertina
coppicing	coppicing
coprophagous	coprophagous
coprophagous specie	coprophagous species
coprophagous species	coprophagous species
copy-and-paste	copy-and-paste
core aerator packing rod	core aerator packing rod
cork-screw	cork-screw
corn-stalk	corn-stalks
cornicle	cornicles
cornu	cornus
cornu ma	cornus mas
cornu sericea	cornus sericea
cornus ma	cornus mas
cornus sericea	cornus sericea
corrosion process	corrosion process
corymb	corymbs
cosmetic	cosmetics
cosmetic problem	cosmetic problem
costing hundreds	costing hundreds
cotoneaster	cotoneaster	cotoneasters
cotton-like hair	cotton-like hairs
cottony hair	cottony hairs
cotulaa	cotulaa
cotulaa’	cotulaa
coumarin	coumarins
coumarin flavour	coumarin flavour
count	counts
counterpart plant	counterpart plants
cousa	cousa
cover	covers
cover crop	cover crop
cox	cox
coxa	coxae
coxae	coxae
crataegus	crataegus
crawling water beetle	crawling water beetles
cream	creams
creamy-white petal	creamy-white petals
creating hole	creating holes
creating page structure	creating page structures
creating recruitment trail	creating recruitment trails
creeper	creeper
creeping phlox	creeping phlox
creeping stem	creeping stem	creeping stems
creeping stoloniferou	creeping stoloniferous
creeping stoloniferou perennial plant	creeping stoloniferous perennial plant
creeping stoloniferous perennial plant	creeping stoloniferous perennial plant
creeping wood sorrel	creeping wood sorrel
creeping yellowcre	creeping yellowcress
creeping yellowcres	creeping yellowcress
criss-crossing groove	criss-crossing grooves
crookneck	crookneck
crop	crops
crop specie	crop species
crop species	crop species
cropland	cropland
cross-pollination	cross-pollination
crossing branch	crossing branches
cubic foot	cubic feet
cucurbit crop	cucurbit crops
cucurbit family	cucurbit family
cucurbita	cucurbita
culinary herb	culinary herb
culinary purpose	culinary purposes
culinary use	culinary use
cultivar	cultivars	cultivar
cultivar exhibiting orange-red leaf	cultivar exhibiting orange-red leaves
cultivars propagated	cultivars propagated
cultivation operation	cultivation operations
cultivator	cultivator
cultural significance	cultural significance
cumulative effect	cumulative effect
curculionidae	curculionidae
curly top virus	curly top virus
current use	current use
cushag	cushag
cut	cuts
cut branch	cut branches
cut flower	cut flowers	cut flower
cut grass	cut grass
cut greenery	cut greenery
cut wood	cut wood
cut-and-come-again crop	cut-and-come-again crop
cut-leaved maple	cut-leaved maple
cutback shrub	cutback shrub
cuticle	cuticle
cutin	cutin
cutting blade	cutting blades
cutting garden	cutting gardens
cyanide	cyanide
cyanogenic glycoside	cyanogenic glycosides
cycle	cycles
cycle life fly stages	cycle life fly stage
cyclic peptide	cyclic peptides
cyclical parthenogenesis	cyclical parthenogenesis
cylinder cutting blade	cylinder cutting blades
cylinder mower	cylinder mower
cylindrical capsule	cylindrical capsule
cyme	cymes
cyprus	cyprus
cyst nematode	cyst nematodes
cystiti	cystitis
cytokine	cytokines
cytotoxicity	cytotoxicity
daisy	daisy
daisy-like flower	daisy-like flowers
damage	damages
damage crop	damage crops
damage soil structure	damage soil structure
dandelion	dandelions
dandelion flower head	dandelion flower head
dandelion flower jam	dandelion flower jam
dandelion population	dandelion populations
dandelion root	dandelion root
darkling beetle	darkling beetle
databasing approach	databasing approach
day	days
dc	dc
deadheading	deadheading
decaying organic matter	decaying organic matter
deciduous	deciduous
deciduous flowering tree native	deciduous flowering tree native
deciduous forest understory	deciduous forest understories
deciduous large shrub	deciduous large shrub
deciduous shrub	deciduous shrubs	deciduous shrub
deciduous tree	deciduous tree	deciduous trees
decoction	decoctions
decomposition process	decomposition process
decorative exfoliating bark	decorative exfoliating bark
decorative flower	decorative flowers
deep-fried basil	deep-fried basil
defense mechanism	defense mechanism
defensive strategy	defensive strategy
defoliated tree	defoliated trees
defoliation	defoliations
defra	defra
degrading enzyme	degrading enzymes
degree	degrees
degree day	degree days
dehydration	dehydration
dendranthema spp	dendranthema spp
dendranthema spp.	dendranthema spp
dentate margin	dentate margins
deposit exploratory trail	deposit exploratory trails
derivative	derivatives
destructive impact	destructive impact
destructive pest	destructive pest
destructive plant pathogen	destructive plant pathogens
destruxin	destruxins
detrimental weed	detrimental weeds
developmental fate	developmental fate
developmental stage	developmental stages
dewikify	dewikify
diabetes treatment	diabetes treatment
diablo	diablo
diagnostics	diagnostic
diaphoretic	diaphoretic
diazinon	diazinon
dicamba	dicamba
dicofol	dicofol
dicotyledon	dicotyledons
difference	differences
different specie	different species
different species	different species
differentiation	differentiation
difficulty	difficulties
dig	digging
digestive function	digestive functions
digestive juice	digestive juices
digestive system	digestive system
digestive tonic	digestive tonic
digestive track	digestive track
digestive tract	digestive tract	digestive tracts
diploid	diploid
diploid dandelion	diploid dandelions
disadvantage	disadvantage
disc flower	disc flower
discoloration	discoloration
disease	diseases
disease control	disease control
disease issue	disease issues
disease list	disease lists
disease management	disease management
disease organism	disease organisms
disease problem	disease problems	disease problem
disease process	disease processes
diseased tree	diseased trees
dish	dishes
disinfectant	disinfectant
disjunct population	disjunct populations
disk floret	disk florets
disorder	disorders
dispersal	dispersal
dispersal mechanism	dispersal mechanism
display	displays
dissectum	dissectum
distal part	distal part
distillation	distillation
distinctive circular	distinctive circular
distinctive leaf shape	distinctive leaf shape
distinctive waved	distinctive waved
distributed world-wide	distributed world-wide
distribution	distribution
distributions	distribution
distributor	distributors
disturbance	disturbances
disturbed ground	disturbed ground
ditylenchu	ditylenchus
ditylenchu dispaci	ditylenchus dispaci
ditylenchus dispaci	ditylenchus dispaci
diuretic	diuretic
diuretic property	diuretic properties
diurnal	diurnal
diverse common name	diverse common names
diverse group	diverse group
diverse light	diverse light
diverse range	diverse range
diverse specie	diverse species
diverse species	diverse species
divided eye	divided eyes
diving beetle	diving beetles
diving beetle predacious	predacious diving beetles
dna	dna
dna molecule	dna molecules
documented case	documented cases
doesn	doesn
doesn’t	doesn
dogwood	dogwood
dolomitic lime	dolomitic lime
domestic gardening	domestic gardening
dormancy	dormancy
dorsal stripe	dorsal stripe
dorsal surface named sus	dorsal surface named siphunculi
douglasii limnanth	limnanthes douglasii
doyenne du commice	doyenne du commice
dozen	dozens
dragonflies capture	dragonflies capture
dragonfly nyad	dragonfly nyads
drainage	drainage
drainage issue	drainage issues
drastic environmental change	drastic environmental change
drawing water	drawing water
drill	drills
dripline	driplines	dripline
dropping	droppings
druce	druce
drummondii	drummondii
drupelet	drupelets
drupelet diameters	drupelet diameter
drupelet mm diameter aggregation	mm diameter aggregation of drupelets
dumping compost	dumping compost
dwarf shoot	dwarf shoot
dwarf size	dwarf size
dyspepsia	dyspepsia
dytiscidae	dytiscidae
dōng téng	dōng téng
e ) -erucifoline	e)-erucifoline
e)-erucifoline	e)-erucifoline
early instar	early instars
eating mile-a-minute weed fruit	eating mile-a-minute weed fruits
eating pokeweed	eating pokeweed
ec health	ec health
ecological niche	ecological niche
ecological succession	ecological succession
ecological threat	ecological threat
economic damage	economic damage
economic importance	economic importance
economic loss	economic losses
economic standpoint	economic standpoint
economical pruning	economical pruning
ecosystem structure	ecosystem structure
edemum	edema
effect	effects
effective control	effective control
effort	efforts
egg	eggs
egg mass	egg masses
eggplant	eggplant
eggshell / compost mix step	eggshell/compost mix step
eggshell/compost mix step	eggshell/compost mix step
egypt	egypt
elaiosome	elaiosome
elateridae	elateridae
elateriform larva	elateriform larvae
elderberry	elderberry
electric fence	electric fences
elegan	elegans
ellagic acid	ellagic acid
elytra	elytra
elytrum	elytra
embryogenesis proceeds	embryogenesis proceeds
emerging foliage	emerging foliage
emmenagogue	emmenagogue
emulsified suspension	emulsified suspension	es
emulsifier	emulsifier
en masse	en masse
en masse foray	en masse forays
encyclopædia britannica	encyclopædia britannica
encycloweedia	encycloweedia
end lobe	end lobe
endopterygote	endopterygotes
endosulfan	endosulfan
enemy	enemies
energy	energy
energy fuel	energy fuel
energy reserve	energy reserves
ensuring reproduction	ensuring reproduction
entertainment space	entertainment space
entire fencerow	entire fencerows
entomogenous fungi	entomogenous fungi
entomogenous fus	entomogenous fungi
entomopathogenic fungi	entomopathogenic fungi
entomopathogenic fungi potential use	potential use of entomopathogenic fungi
entomopathogenic fus	entomopathogenic fungi
entomopathogenic nematode	entomopathogenic nematodes
entry hole	entry holes
environment	environments
environmental condition	environmental conditions
enzyme	enzyme
epa	epa
ephemeral plant	ephemeral plants
epidermal cell	epidermal cells
epilepsy	epilepsy
epileptic seizure	epileptic seizure
epilobium angustifolium	epilobium angustifolium
equilibria	equilibria
equilibrium	equilibrium
equipment	equipment
equipment duch	equipment duch
ericaceae	ericaceae
ericaceous plant	ericaceous plants
erstwhile nematode parasite	erstwhile nematode parasites
erubescen	erubescens
erwinia	erwinia
esophageal cancer	esophageal cancer
esperanto	esperanto
essential amino acid	essential amino acids
essential oil	essential oil
essential oil lemon balm	lemon balm essential oil
ethnobotany	ethnobotany
ethylene dibromide	ethylene dibromide
etymology	etymology
eucalyptus	eucalyptus
eupator	eupator
eupatoria	eupatoria
eurasia	eurasia
eurasia wetland	wetlands of eurasia
eurasian continent	eurasian continent
eurasian families	eurasian family
eurasian origin family lymantriidae	family lymantriidae of eurasian origin
evasive action	evasive action
evening grosbeak	evening grosbeak
evolutionary battle	evolutionary battle
exam	exams
example agrobacterium	example agrobacterium
example manual	example manual
excellent container plant	excellent container plant
excess	excesses
excessive rate	excessive rates
excluded method	excluded methods
exclusive right	exclusive rights
excrement	excrement
excretion	excretion
excretions bind	excretions bind
excretory pore	excretory pore
exfoliating bark	exfoliating bark
exhaustive discussion	exhaustive discussion
exhaustive technical manual	exhaustive technical manual
exhibit	exhibit
exhibit aposematism	exhibit aposematism
exhibit symptom	exhibit symptoms
exhibit symptom weakened tree	weakened trees exhibit symptoms
exhibiting nymphal characteristic	exhibiting nymphal characteristics
exhibiting orange-red leaf	exhibiting orange-red leaves
exhibiting thermogenesi	exhibiting thermogenesis
existing specimen	existing specimens
exopolysaccharide	exopolysaccharides
exoskeleton	exoskeleton
exotic insect	exotic insects
expensive wholesale	expensive wholesale
experimental condition	experimental conditions
exploratory trail	exploratory trails
exploratory trail caterpillar deposit	caterpillars deposit exploratory trails
exploratory trail caterpillars deposit	caterpillars deposit exploratory trails
explosive discharge	explosive discharge
exporter	exporters
extension service branch	extension service branches
extensive canopy	extensive canopy
extensive history	extensive history
extensive work	extensive work
external evidence	external evidence
external link	external links
external link section	external link sections
external links	external links
external pressure	external pressures
external site	external sites
extra-haustorial matrix	extra-haustorial matrix
extract form	extract form
eye	eyes
eye ailment	eye ailments
eye irritation	eye irritation
facing bud	facing bud
facing shoot	facing shoots
fact die	fact die
factor	factors
fahrenheit	fahrenheit
fall cleanup	fall cleanup
fall color	fall color
fall display	fall display
fall migration	fall migration
fall planting	fall plantings
fall tiphia	fall tiphia
fall tiphon	fall tiphia
fall webworm	fall webworm
falooda	falooda
families	family
family	families
family asteraceae	family asteraceae
family boraginaceae	family boraginaceae
family buprestidae	family buprestidae
family caprifoliaceae	family caprifoliaceae
family carabidae	family carabidae
family cephidae	family cephidae
family cerambycidae	family cerambycidae
family chysomelidae	family chysomelidae
family coccinellidae	family coccinellidae
family cucurbitae	family cucurbitae
family feed	family feed
family gyrinidae	family gyrinidae
family histeridae	family histeridae
family lamiaceae	family lamiaceae
family meloidae	family meloidae
family noctuidae	family noctuidae
family oxalidaceae	family oxalidaceae
family phengodidae glowworm	glowworms of the family phengodidae
family polygonaceae	family polygonaceae
family primulaceae	family primulaceae
family psychidae	family psychidae
family rosaceae	family rosaceae
family scarabaeidae	family scarabaeidae
family silphidae	family silphidae
family staphylinidae	family staphylinidae
family tetranychidae	family tetranychidae
fanleaf grapevine vectors	fanleaf grapevine vector
farming operation	farming operations
farming w masanobu fukuoka	masanobu fukuoka farming w
farâmusham nakon	farâmusham nakon
fatal disease	fatal disease	fatal diseases
fauna	fauna
fauon	fauna
feathered maiden	feathered maiden
feathered stipule	feathered stipules
feature	features
febrifuge	febrifuge
fecal matter	fecal matter
feed metering system	feed metering system
feeder	feeders
feeding damage	feeding damage
felon herb	felon herb
female	females
female scale	female scales
fence	fences
fertility level	fertility levels
fertilization	fertilization
fertilizer	fertilizer	fertilizers
fertilizer mix	fertilizer mix
fever	fevers
ffrf	ffrf
fibre wood sources	fibre wood source
fibres	fibre
fibrous	fibrous
fibrous leaf	fibrous leaves
fibrous organic matter	fibrous organic matter
fibrous outer layer	fibrous outer layer
fibrous root	fibrous roots
ficaria bulbifer	ficaria bulbifer
ficaria ficaria	ficaria ficaria
field	fields
fighting ragweed	fighting ragweed
fil	fil
film	films
filter feeder	filter feeders
fine filament	fine filaments
fine hair	fine hairs
fine quality	fine quality
fine tanbark	fine tanbark
fine web	fine web
fine yellow veining	fine yellow veining
fine-pruning	fine-pruning
finger-like appendage	finger-like appendages
fire hazard	fire hazard
fireblight	fireblight
fireweed	fireweed
first-year plant	first-year plants
fishing rod	fishing rods
fissuring	fissuring
fittest	fittest
flagellum	flagellum
flat-leaf basil	flat-leaf basil
flavonoid	flavonoids
flea beetle / s	flea beetle/s
flea beetle/s	flea beetle/s
flight pattern	flight patterns
flight period	flight periods
flight wing	flight wings
floating row cover	floating row covers
floodplain	floodplains
flora	flora
flora soil balances	flora soil balance
floral arrangement	floral arrangements
floral emblem	floral emblem
floral organ	floral organs
floret	florets
floridotarsonemus	floridotarsonemus
floridu	floridus
floristry	floristry
flower	flowers	flower
flower head	flower heads
flowering clone treneaguee non	non flowering clone treneaguee
flowering moss	flowering moss
flowering stem	flowering stems
flu	flu
fluid	fluid
flus	flora
flux	flux
fluxroot	fluxroot
fly cycling	fly cycle
fly life cycle	fly life cycle
fly life cycle larval stage	larval stage of the fly life cycle
fly tachinid targets	fly tachinid target
flying	fly
flying adult	flying adults
flying insect	flying insects
foetid potho	foetid pothos
folate	folate
foliage	foliage
foliar blight	foliar blights
foliar disease	foliar diseases
foliar feeding	foliar feeding
foliar herbicide spray	foliar herbicide sprays
foliar infection	foliar infections
foliar nematode	foliar nematodes
foliar spotting	foliar spotting
folkname	folkname	folknames
follicle	follicles
folloring genus	folloring genera
follower color	follower color
food body	food body
food canal	food canal
food crop	food crops
food intake	food intake
food pemmican	food pemmican
food plant	food plant	food plants
food preservative	food preservative
food reserve	food reserve
food scent	food scents
food shop	food shops
food source	food sources	food source
food store	food stores
food-plant	food-plant
foodplant	foodplants
foodplant leaf	foodplant leaves
foot	feet
footpath	footpaths
forager	forager
foray	forays
forest understory	forest understory
forested land	forested lands
forewing	forewings	forewing
form	forms
form association	form associations
form horticulture / chapter	form horticulture/chapter
form horticulture/chapter	form horticulture/chapter
formal appearance	formal appearance
formal landscape	formal landscapes
formative pruning	formative pruning
forming clonal colony	forming clonal colonies
forms association	forms associations
formulation	formulation	formulations
fossorial leg	fossorial legs
foundation	foundations
four / square	four/square
four/square	four/square
fourth-part	fourth-part
foxglove tree	foxglove tree
fra	frass
fragment	fragments
fras	frass
frass dropping	frass dropping
freenode	freenode
freethought symbol	symbol of freethought
frondosa	frondosa
front part	front part
fruit	fruits	fruit
fruit bud	fruit buds
fruit cluster	fruit cluster
fruit dish	fruit dishes
fruit grower	fruit growers
fruit jam	fruit jams
fruit load	fruit load
fruit production	fruit production
fruit set	fruit set
fruit tree	fruit trees
fruit tree spider mite	fruit tree spider mites
fruiting	fruiting
fruiting body	fruiting bodies
fruiting spur	fruiting spurs
fruiting tree	fruiting trees
ft	ft
ft.	ft
fueling pollination	fueling pollination
fugino pink	fugino pink
ful sun	ful sun
fumigation	fumigation
fumosoroseus paecilomyce	paecilomyces fumosoroseus
function	functions
fungal cell wall	fungal cell walls
fungal diea	fungal dieases
fungal dieas	fungal dieases
fungal disease	fungal disease
fungal infection	fungal infection
fungal membrane	fungal membranes
fungal pathogen	fungal pathogens
fungal plant pathogen	fungal plant pathogens
fungal spore	fungal spores
fungi	fungi
fungi appresorial formation	fungi appresorial formation
fungi entomopathogenic using	fungi entomopathogenic use
fungi garlics	fungi garlic
fungi mycelia	mycelia of fungi
fungi specialised entension	specialised entension of the fungi
fungi utilise garlic mustard species	species of fungi utilise garlic mustard
fungicide	fungicide
fungus	fungus
fungus attack	fungus attacks
fungus overwinter	fungus overwinters
fungus specie	fungus species
fungus species	fungus species
fungus-like organism	fungus-like organism
further symptom	further symptoms
fus	fungi
galactagogue	galactagogue
galanthus	galanthus
garden	gardens	gardening
garden cultivar	garden cultivars
garden fauna	garden fauna
garden fauon	garden fauna
garden plant	garden plants
gardener	gardeners
gardener organic beliefs	gardener organic belief
gardeners	gardener
gardeners preference	gardeners preference
gardening system	gardening systems
garlic	garlic
garlic-like flavour	garlic-like flavour
garlic-like odour	garlic-like odour
gastrointestinal upset	gastrointestinal upset
gastropod mollusc	gastropod molluscs
gelatinous	gelatinous
geminiviru	geminiviruses
geminivirus	geminiviruses
gender	gender
gene expression	gene expression
gene pool	gene pool
genera	genus
generalist	generalists
generic name	generic name
genetic contact	genetic contact
genital opening	genital opening
genitalia	genitalia
genoa	genoa
genome	genomes
genome sequenced	genome sequenced
genra	genras
genus	genus
genus lysichiton	genus lysichiton
genus name	genus name
genus neoseiulus	genus neoseiulus
genus phytolacca	genus phytolacca
genus plant species	plant species of the genus
genus situations	genus situation
genus species	species of the genus
genus taxonomical situation	taxonomical situation of the genus
geographic area	geographic areas
geographic range	geographic range
geraniol	geraniol
germ tube tip	germ tube tip
germination	germination
getting plant disease	getting plant diseases
giant ragweed	giant ragweed
giving rise	giving rise
glandular system	glandular system
glandulosa	glandulosa
glass house	glass houses
glaucous blue-green	glaucous blue-green
glechome hederacea	glechome hederacea
glialka	glialka
gliphogan	gliphogan
gliphosat-based	gliphosat-based
globose dark blue berry	globose dark blue berry
glucoside	glucosides
gluphosinat-ammonia	gluphosinat-ammonia
glyphosate	glyphosate
glyphosate application	applications of glyphosate
glyphosate applications	glyphosate application
glyphosate foliar application	foliar applications of glyphosate
glyphosate isopropylamine salt	isopropylamine salt of glyphosate
glyphosate molecule	glyphosate molecule
glyphosate salts	glyphosate salt
glyphosate-tolerant counterpart plant	glyphosate-tolerant counterpart plants
goldenrod	goldenrod	goldenrods
goldenrod pollen	goldenrod pollen
goldenrod species	species of goldenrods
goldenrods bloom	goldenrods bloom
gordaldo	gordaldo
gout	gout
goutweed	goutweed
government agency	government agencies
grain drill	grain drills
grain field	grain fields
grain product	grain products
gramini	graminis
grand-daughter	grand-daughters
grapevine fanleaf virus	grapevine fanleaf virus
grapevine fanleaf virus vector	vector of gflv
grapevine viruses	grapevine virus
grapevines	grapevine
grass	grasses
grass growth	grass growth
great ragweed	great ragweed
greater plantago	greater plantago
greece	greece
greek	greeks
greenish-brown cutworm	greenish-brown cutworms
greenish-brown fra	greenish-brown frass
greenish-brown fras	greenish-brown frass
greenish-white	greenish-white
grey-brown	grey-brown
ground	grounds
ground beetle	ground beetles
ground beetle / s	ground beetle/s
ground beetle/s	ground beetle/s
ground copper sulphate	ground copper sulphate
ground cover	ground cover
ground cover plant	ground cover plant
ground ivy	ground ivy
ground level	ground level
ground limestone ordolomiticc lime	ground limestone ordolomiticc lime
ground pink	ground pink
ground plant	ground plants
ground-cover	ground-cover
groundcover	groundcover
group display	group displays
group feeding	group feeding
grower	growers
growing above-ground	growing above-ground
growing area	growing area
growing condition	growing conditions
growing degree day	growing degree days
growing point	growing points
growing practice	growing practice	growing practices
growing practice organic	organic growing practices
growing tip	growing tips
growing transplant	growing transplants
growth	growth	growths
growth habit	growth habits
growth hormone auxin	growth hormone auxin
growth rate	growth rates
growth twig	growth twigs
grub-like	grub-like
grub-like borer	grub-like borer
guaraniticum	guaranitica
guatemala	guatemala
guidebook	guidebook
gymnosporangium	gymnosporangium
gynecological treatment	gynecological treatment
gypsy moth	gypsy moth	gypsy moths
gypsy moth egg	gypsy moth eggs
gypsy moth egg mass	gypsy moth egg masses
gypsy moth female	gypsy moth females
gypsy moth larva	gypsy moth larvae
gypsy moth outbreak	gypsy moth outbreaks
gypsy moth population	gypsy moth populations
gēngtāng	gēngtāng
h-atpa	h-atpases
h-atpas	h-atpases
ha	ha
habit	habits
habitat	habitats
hackberry	hackberry
hair	hairs
hair-like setae	hair-like setae
half-moon edge cutter	half-moon edge cutter
half-way	half-way
haliplidae	haliplidae
halva tahini preparations	halva tahini preparation
haly	halys
halyomorpha haly	halyomorpha halys
hand axe	hand axe
hand cream	hand creams
hand cultivator	hand cultivator
hand dig	hand digging
hand digging	hand digging
hand pollination	hand pollination
hand push mower	hand push mower
hand seeder	hand seeder
hand sowing	hand sowing
hand-pulling	hand-pulling
hand-weed	hand-weed
hanging upside	hanging upside
hard scale	hard scales
hard-wearing	hard-wearing
hardiness zone	hardiness zones
hardpan	hardpan
hardwood tree	hardwood trees
hardwood tree notorious pest	notorious pests of hardwood trees
harm threshold	harm threshold
harrisburg area	harrisburg area
haustoria	haustoria
haustorial body	haustorial body
haustorial mother cell	haustorial mother cell
having paper	having paper
hawaii	hawaii
hawkbit	hawkbit
hawksbeard	hawksbeards
hawkweed	hawkweeds
hayfever	hayfever
hayfever symptom	hayfever symptoms
hazardous tree	hazardous trees
hazardous undertaking	hazardous undertaking
head	heads
head capsule	head capsules
health food shop	health food shops
health food store	health food stores
health issue	health issues
health precaution	health precautions
health risk	health risks
healthy tree	healthy trees
heart-shaped leaf	heart-shaped leaves
heartsease	heartsease
heartwood	heartwood
heat composting	heat composting
heat gain	heat gain
heat source	heat source
heavy equipment	heavy equipment
heavy infestation	heavy infestations
hectare	hectare
hedge garlic	hedge garlic
height	heights
hemimetabolous insect	hemimetabolous insects
hemiptera	hemiptera
hemiptera order divisions	hemiptera order division
hemlock tree	hemlock trees
hemlock woolly adelgid	hwa	hemlock woolly adelgid
hemlocks	hemlock
hemorrhage	hemorrhage
hemorrhoid	hemorrhoids
herbaceaous plant	herbaceaous plant
herbaceous	herbaceous
herbaceous biennial plant	herbaceous biennial plant
herbaceous flowering plant native	herbaceous flowering plant native
herbaceous ornamental plant	herbaceous ornamental plants
herbaceous peony	herbaceous peonies
herbaceous perennial	herbaceous perennial
herbaceous perennial plant	herbaceous perennial plant
herbaceous perennial plant native	herbaceous perennial plant native
herbaceous plant	herbaceous plants	herbaceous plant
herbaceous plant native	herbaceous plant native
herbaceous plant prune	herbaceous plant pruning
herbaceous plant pruning	herbaceous plant pruning
herbicide	herbicide	herbicides
herbicide spray	herbicide sprays
herbicide use	herbicide use
herbivorous	herbivorous
herbivorous insect	herbivorous insects
hermaphrodite flower head	hermaphrodite flower heads
hermaphroditism	hermaphroditism
heteroptera	heteroptera
hexana	hexane
hexane	hexane
hexose sugar transporter	hexose sugar transporters
highway	highways
hindleg scale	hindleg scales
hindwing	hindwings
hispid	hispid
histological damage	histological damages
historical use	historical use
hole	holes
holistic approach	holistic approach
holocyclical life circle	holocyclical life circle
home fruit grower	home fruit growers
home garden	home gardens	home gardening
home gardener	home gardeners
home reader	home reader
home security quality	home security qualities
homeopathic remedy	homeopathic remedy
homoptera	homoptera
honeysuckles	honeysuckle
honshū	honshū
hook	hooks
hook-like part	hook-like parts
horseweed	horseweed
horticultural oil	horticultural oil
horticultural trade	horticultural trade
horticultural worker	horticultural workers
horticulturalist	horticulturalists
horticulture	horticulture
horticulture / chapter / page	horticulture/chapter/page
horticulture student	horticulture students
horticulture trade	horticulture trade
horticulture/chapter/page	horticulture/chapter/page
horticulture/using template	horticulture/using templates
hortwort	hortworts
host	hosts
host crop	host crops
host foliages	host foliage
host organism	host organism
host plant	host plants	host plant
host plant alternancy	host plant alternancy
host plant.	host plant
host range	host range	host ranges
host specie	host species
host species	host species
host tree	host trees	host tree
host tree foliage	foliage of the host tree
hosting	host
hotricultural chemical	hotricultural chemicals
house	houses
house plant	house plants
household use	household use
houseplant	houseplants
housing foundation	housing foundations
hoverfly	hoverflies
human	humans
humidity	humidity
humidity rise	humidity rises
humus-rich	humus-rich
hundreds	hundreds
hungary	hungary
hungary water	hungary water
hybridization	hybridization
hydraulic lift	hydraulic lift
hydrogen cyanide	hydrogen cyanide
hydrologic process	hydrologic processes
hydrophilidae	hydrophilidae
hydrophobic interaction	hydrophobic interactions
hydrophobic mucilaginou	hydrophobic mucilaginous
hydrophobic mucilaginous	hydrophobic mucilaginous
hydrostatic pressure	hydrostatic pressure
hymenoptera	hymenoptera
hymenoptus	hymenoptera
hyperecteina	hyperecteina
hypermetamorphosi	hypermetamorphosis
hyphae	hyphae
hypochoeri	hypochoeris
hyssop	hyssop
iberia	iberia
idaeu	idaeus
idaho	idaho
identification guide	identification guide
identifying defense	identifying defense
illinoi	illinois
imago	imago
imazapyr	imazapyr
impatien	impatiens
import / merge request	import/merge request
import tool	import tool
import/merge request	import/merge request
impressive underground structure	impressive underground structures
improvement	improvements
improving memory	improving memory
improving soil quality	improving soil quality
in-host multiplication	in-host multiplication
inactive ingredient	inactive ingredients
incentive	incentives
including bird	including birds
including bur marigold	including bur marigold
including carbuncle	including carbuncles
including cottonwood	including cottonwood
including giant leopard moth lepidoptera species	lepidoptera species including giant leopard moth
including hawaii	including hawaii
including hay fever	including hay fever
including herbicide	including herbicides
including hermaphroditism	including hermaphroditism
including human	including humans
including illinoi	including illinois
including moss	including mosses
including pathogen	including pathogens
including plant	including plants
including silkworm	including silkworms
including source	including sources
including storm sewer	including storm sewers
including strawberry	including strawberries
including sulfur dioxide	including sulfur dioxide
including winter	including winter
inconspicuous stipule	inconspicuous stipules
incorporating temperature control	incorporating temperature controls
increase air circulation	increase air circulation
increment	increments
indication	indications
individual	individuals
individual gardener	individual gardeners
individual lesion	individual lesions
individual pest	individual pests
individual pine branch	individual pine branches
individual plant	individual plants
individual rust fungi	individual rust fungi
individual rust fus	individual rust fungi
individual seed	individual seeds
individual specie	individual species
individual species	individual species
individual specimen	individual specimens
indonesia	indonesia
industry	industries
inexperienced gardener	inexperienced gardeners
infection	infection	infections
infection strategy	infection strategies
infectious organism	infectious organisms
infective agent	infective agent
infestation	infestations
infestations result	infestations result
inflammation	inflammations
inflorescence	inflorescence
influenza	influenza
infobox	infoboxes
infused st	infused st
infused st.	infused st
ingestion	ingestion
ingredient	ingredients
inhibition characteristic	inhibition characteristics
injury	injury
inkberry	inkberry
input	inputs
insect	insect	insects
insect bite	insect bites
insect control	insect control
insect host	insect host
insect order	insect orders
insect repellent	insect repellent
insect specie	insect species
insect species	insect species
insecticidal cyclic peptide	insecticidal cyclic peptides
insecticidal effect	insecticidal effects
insecticide	insecticide
insecticide application	applications of insecticide
insects	insect
inspection rounded	inspection rounded
instar	instars	instar
instar chew	instar chews
instar feed	instar feed
instars feed	instars feed
institution	institutions
integerrimine	integerrimine
integral	integral
intensive gardening popularized	intensive gardening popularized
intensive veetable garden	intensive veetable gardens
intentional cross-breeding	intentional cross-breeding
inter-generational effect	inter-generational effects
interaction	interactions
internal bleeding	internal bleeding
internal budding	internal budding
internal degrees	internal degree
internal feeder	internal feeders
internal organ degree twisting	degree twisting of internal organs
internal shell	internal shells
internal treatment	internal treatments
internal/external pressure	internal/external pressures
interrow	interrows
interrows mulch	interrows mulches
interruption	interruption
interspecific hybrid	interspecific hybrid
interval	intervals
intervention	intervention
interwiki link	interwiki links
interwiki links	interwiki links
introduced aphid-like insect	introduced aphid-like insect
introducing predator	introducing predators
introducing seed	introducing seed
introduction	introduction
introductions	introduction
inulin	inulin
invasive character	invasive character
invasive exotic	invasive exotics
invasive exotic weed	invasive exotic weed
invasive nature	invasive nature
invasive plant	invasive plant
invasive specie	invasive species
invasive species	invasive species
invasive tree	invasive trees
invasive weed	invasive weed
invasive weed tree	invasive weed tree
investigation	investigation
involving dozen	involving dozens
involving dozen group display	group displays involving dozens
ion flux	ion fluxes
iran	iran
irc channel	irc channel
iron	iron
irregular form	irregular form
island	islands
isovaleric acid	isovaleric acid
issue	issues
jacobine	jacobine
jacoline	jacoline
jaconine	jaconine
jacozine	jacozine
jam	jams
james-wort	james-wort
jargonelle	jargonelle
jesuit priest	jesuit priest
johnny jump	johnny jump
josephine de maline	josephine de malines
juglan	juglans
juice	juices
juneberry	juneberry
jute-like fiber	jute-like fiber
jīn yín huā	jīn yín huā
karyotype	karyotype
kashmir	kashmir
kda nonglycosylated protein	kda nonglycosylated protein
keek	keek
kg	kg
kill worm	kill worms
king mithridate	king mithridates
km²	km²
knot nematode	knot nematodes
koke dera	koke dera
korea	korea
kudzu	kudzu
kyoto	kyoto
l. maackii	l. maackii
label	labels
labial palpi	labial palpi
lac scale	lac scales
lack cell wall	lack cell walls
lacking petal	lacking petals
lacking ray-floret	lacking ray-florets
lady beetle / s	lady beetle/s
lady beetle/s	lady beetle/s
ladybird	ladybird
ladybug	ladybugs
laevi	laevis
lanceolate	lanceolate
lanceolate milkweed	lanceolate milkweed
land	lands
land plant	land plants
land-living slug	land-living slugs
landscape	landscapes
landscape tree	landscape tree
language	languages
large ground beetle	large ground beetles
large infestation	large infestations
large population	large populations
large quantity	large quantities
large shrub	large shrub
large-foliaged	large-foliaged
larva	larvae
larvae reach maturity	larvae reach maturity
larval food plant	larval food plant
larval form	larval form
larval instar	larval instars
larval life	larval life
larval period	larval period
larval stage	larval stage
larval survival	larval survival
lateral	laterals
lateral bud	lateral buds
lateral bud growth	lateral bud growth
latus p. densities	latus p. density
launch en masse foray	launch en masse forays
laurocerasu	laurocerasus
lauru	laurus
lauru nobili	laurus nobilis
laurus nobili	laurus nobilis
law	laws
lawn	lawns
lawn area	lawn areas
lawn care organic pesticide	lawn care organic pesticides
lawn mowing	lawn mowings
lawnmowers available	lawnmowers available
lawns	lawn
layer	layers
lb	lb
lead growth	lead growth
leaf	leaves
leaf axil	leaf axils
leaf decoction	leaf decoction
leaf petiola	leaf petiole
leaf petiole	leaf petiole
leaf shredder	leaf shredder
leaf venation	leaf venation
leaf-curling	leaf-curling
leaf-rolling	leaf-rolling
leafhopper	leafhoppers
leg	legs
legal requirement	legal requirements
legume	legumes
lemon balm	lemon balm
lemon balm (	lemon balm (
lemon balm ( "melissa officinali " )	lemon balm (
lemony smell	lemony smell
leopold trouvelot	leopold trouvelot
lepidoptera	lepidoptera
lepidoptera specie	lepidoptera species
lepidoptera species	lepidoptera species	species of lepidoptera
leptinotarsa decemlineata	leptinotarsa decemlineata
lesion	lesions
lesion nematode	lesion nematodes
lesson plan	lesson plan
lethal effect	lethal effect
leucodermi	leucodermis
level	levels
liatri	liatris
life cycle	life cycles	life cycle
life form	life forms
life-cycle	life-cycle
life-history	life-history
lifecycle	lifecycle
lifespan	lifespan
limbing	limbing
limeniti arthemi	limenitis arthemis
limenitis arthemi	limenitis arthemis
limits gardener	limits gardeners
limnanthe	limnanthes
line	lines
linguistic reworking	linguistic reworking
link	links
link section	link sections
lip	lips
list	lists
little maintenance	little maintenance
liverwort	liverworts
lives	life
livestock owner	livestock owners
living bark	living bark
living cell	living cells
living mulch	living mulch
living organism	living organisms
living plant tissue	living plant tissue
living tissue	living tissues
loam	loam
lobe	lobes
location	locations
long distance dispersal	long distance dispersal
long-distance primary weed mile-a-minute agents	long-distance primary weed mile-a-minute agent
longer shoot	longer shoots
longer-term cover	longer-term cover
longhorn beetle	longhorn beetles
longitudinal one	longitudinal ones
longitudinal stripe	longitudinal stripes
longitudinal vein	longitudinal vein
longleaf pine straw	longleaf pine straw
lonicera	lonicera
lonicera maackii	lonicera maackii
lonicera mus	lonicera maackii
looking plant	looking plant
loosestrifa	loosestrife
loosestrife	loosestrife
loosestrife family	loosestrife family
lopper	loppers
lorbergii	lorbergii
loss	losses
low-maintenance crop	low-maintenance crops
lower shoot	lower shoots
luteolin	luteolin
lymantria dispar	lymantria dispar
lythraceae	lythraceae
lythrum	lythrum
lythrum salicaria	lythrum salicaria
m diameter	m diameter
m high	m high
ma	mas
macblack	macblack
maculatu	maculatus
magical talisman	magical talisman
maiden	maiden
mail order	mail order
maincrop potato	maincrop potatoes
maincrop variety	maincrop varieties
maintaining flexibility	maintaining flexibility
making effort	making efforts
making jam	making jam
making maple syrup	making maple syrup
malacosoma americanum	malacosoma americanum
male	males
maloideae	maloideae
malus	malus
malvaceae	malvaceae
mammal specie	mammal species
mammal species	mammal species
mammalian test system	mammalian test systems
management option	management options
management strategy	management strategy
managerial control	managerial control
manchuria	manchuria
manual	manual
manufacturer	manufacturers
manufacturers	manufacturer
manure	manure
manure source	manure source
maple	maple	maples
maple leaf	maple leaves
maple seed	maple seeds
maple specie	maple species
maple species	maple species
maple syrup	maple syrup
maple-like	maple-like
maples	maple
mare reproductive loss syndrome	mare reproductive loss syndrome	mrls
margin	margins
marketshare	marketshare
marking	markings
mass	masses
mass landscape	mass landscape
massachusett	massachusetts
massage oil	massage oil
masse foray	masse forays
massive leaf	massive leaves
matchlock mechanism	matchlock mechanism
material	materials
mating-type	mating-types
matricaria discoidea	matricaria discoidea
matricarioide	matricarioides
mature seed	mature seeds
maturity	maturity
maxillary	maxillary
maximal protection	maximal protection
meadowlark	meadowlark
meadowsweet	meadowsweet
mealybug	mealybug	mealybugs
mealybug female	mealybug females
mealybug species	species of mealybug
mechanical color	mechanical colors
mechanical method	mechanical methods
mechanical process	mechanical process
mechanosensitive calcium ion channel	mechanosensitive calcium ion channel
medallon	medallon
medicinal action	medicinal action
medicinal function	medicinal functions
medicinal herb	medicinal herb
medicinal plant	medicinal plant
medicinal property	medicinal properties
medicinal purpose	medicinal purposes
medicinal system	medicinal system
medicinal use	medicinal uses
medicinal value	medicinal value
medieval time	medieval times
mediterranean	mediterranean
mediterranean basil	mediterranean basils
mediterranean basil cultivar	mediterranean basil cultivars
mediterranean climate	mediterranean climate
mediterranean cuisine	mediterranean cuisine
mediterranean region	mediterranean region
medium-small plant nine/square	nine/square for medium-small plants
melezitose	melezitose
melilot	melilot
memory	memory
men	menses
menorrhagia	menorrhagia
mens	menses
mense	menses
menstrual disorder	menstrual disorders
menstrual problem	menstrual problems
menstruation	menstruation
meristem	meristem
meristem growth	meristem growth
mesophyll cell	mesophyll cells
mespilus	mespilus
metabolic heat	metabolic heat
metallic blue	metallic blue
metallic wood-boring beetle	metallic wood-boring beetles
metallic-copper	metallic-copper
metarhizium anisopliae	metarhizium anisopliae
method	methods
methyl	methyl
methyl bromide	methyl bromide
metsulfuron methyl	metsulfuron methyl
mexico	mexico
michigan	michigan
micro-biocontrol	micro-biocontrols
microclimate	microclimate
microorganism	microorganisms
microscopic spore	microscopic spores
microtubule	microtubules
mid- to	mid- to
mid-atlantic united state	mid-atlantic united states
mid-autumn	mid-autumn
mid-june	mid-june
mid-may	mid-may
mid-spring	mid-spring
midrib	midrib
midwest	midwest
mile-a-minute	mile-a-minute
mile-a-minute ability	ability of mile-a-minute
mile-a-minute distribution	distribution of mile-a-minute
mile-a-minute introduction	introduction of mile-a-minute
mile-a-minute weed	mile-a-minute weed
mile-a-minute weed fruit	mile-a-minute weed fruits
mile-a-minute weed primary long-distance dispersal agent	primary long-distance dispersal agents of mile-a-minute weed
milfoil	milfoil
milkweed	milkweed
mine drainage	mine drainage
mineral	minerals
miniature glass house	miniature glass houses
minnesota	minnesota
mint family lamiaceae	mint family lamiaceae
minute seed	minute seeds
mis-information	mis-information
mite	mites
mithridate war	mithridates wars
mithridates war	mithridates wars
mitosporic fungus	mitosporic fungus
mitotic	mitotic
mix	mixes
mm drupelet aggregations	mm drupelet aggregation
mms	mm
model organism	model organism
modern cultivar	modern cultivars
module	module
module-by-module	module-by-module
moisture condition	moisture conditions
moisture retention	moisture retention
molecule	molecules
mollicute	mollicutes
mongolia	mongolia
monitor	monitor
monoecious plant	monoecious plant
monofloral honey	monofloral honey
monofloral honey|honey	monofloral honey
monophagou	monophagous
monophagous	monophagous
monotypic field	monotypic fields
morphological difference	morphological differences
mosquito	mosquitos
mosquito control program	mosquito control programs
mosquito net	mosquito nets
mosquito population	mosquito populations
mosquito repellant	repellant for mosquitos
mosquito repellent	mosquito repellent
mosquitoes	mosquito
moss phlox	moss phlox
most form	most forms
most gardener	most gardeners
most lawn area	most lawn areas
most plant pathogenic bacterium	most plant pathogenic bacteria
most plant virus	most plant viruses
moth	moths	moth
moth egg	moth eggs
moth egg mass	moth egg masses
moth female	moth females
moth outbreak	moth outbreaks
moth population	moth populations
moths	moth
motile zoospore	motile zoospores
mounded	mounded
mountain	mountains
mountain phlox	mountain phlox
mouthpart	mouthparts
movement	movements
movement protein	movement protein
mower blade	mower blades
mowing	mowings
mt fuji	mt fuji
mucilaginou	mucilaginous
mucous membrane	mucous membranes
mucronate apex	mucronate apex
mucus problem	mucus problems
mugwort	mugwort
mukdenia rossii	mukdenia rossii
mul mang cho	mul mang cho
mulch	mulch	mulches
mulch barrier	mulch barriers
mulch barriers paulownia tomentosum	mulch barriers paulownia tomentosa
mulch-like cover crop	mulch-like cover crop
multi-segmented	multi-segmented
multi-stemmed	multi-stemmed
multicelluar worm	multicelluar worm
multiflora	multiflora
multiflora rose	multiflora rose
mungbean beetle	mungbean beetle
mus	maackii
muscardine disease	muscardine disease
muscari	muscari
muscle	muscles
musculature	musculature
mustard-family weed	mustard-family weeds
mutualistic relationship	mutualistic relationship
mycoplasma	mycoplasmas
mycorrhizal fungi	mycorrhizal fungi
mycorrhizal fus	mycorrhizal fungi
myosoti	myosotis
myosoti alpestri	myosotis alpestris
myosoti scorpioide	myosotis scorpioides
myosoti sylvatica	myosotis sylvatica
myosotis alpestri	myosotis alpestris
myosotis scorpioide	myosotis scorpioides
myosotis specie	myosotis species
myosotis species	myosotis species
myosotis sylvatica	myosotis sylvatica
myzu	myzus
myzu persicae	myzus persicae
myzus persicae	myzus persicae
name	names
name amur honeysuckle	name amur honeysuckle
name black raspberry	name black raspberry
name cotton thistle	name cotton thistle
name cultivar	name cultivars
name mealybug	name mealybug
name purple raspberry	name purple raspberries
name saskatoon	name saskatoon
name scotch thistle	name scotch thistle
name serviceberry	name serviceberry
named chromista	named chromista
named siphunculi dorsal surface	dorsal surface named siphunculi
named sus	named siphunculi
nanking	nanking
nantucketensi	nantucketensis
nasal passage	nasal passages
native american	native americans
naturalised specie	naturalised species
naturalised species	naturalised species
naturalising	naturalising
nba	nba
neater	neater
nebraska	nebraska
neck band bridge	neck band bridges
necrophagous insect	necrophagous insects
necrophagous specie	necrophagous species
necrophagous species	necrophagous species
necrotroph	necrotrophs
nectar-rich flower	nectar-rich flowers
nectrophic lifestyle	nectrophic lifestyle
need shade	need shade
needing culling	needing culling
needle-like leaf	needle-like leaves
neem	neem
neem cake	neem cake
neem extract administration traditional route	traditional routes of administration of neem extracts
neem folks	neem folk
neem oil	neem oil
neem oil azadirachtin content	azadirachtin content of neem oil
neem oil extraction process	extraction process for neem oil
neem oil yield	neem oil yield
neem seed	neem seeds	neem seed
neem seed kernel	neem seed kernels
neem seed oil	neem seed oil
neem tree	neem tree
neem various folk remedy	various folk remedies for neem
neighboring state	neighboring states
nema	nema
nematoda	nematode
nematode	nematodes	nematode
nematode abundance	abundance of nematodes
nematode family	nematode families
nematode parasite	nematode parasites
nematode specie	nematode species
nematode species	nematode species
nematode variety	nematode varieties
neoteny	neoteny
neotonic	neotonic
nerve cord	nerve cord
nest	nests
net	nets
neuron mapped	neuron mapped
never-ending task	never-ending task
nevo	nevo
new content	new content
new england forest system	new england forest system
new mexico	new mexico
new zealand	new zealand
newer variety	newer varieties
newfoundlander	newfoundlanders
newspaper act	newspaper acts
newspaper-and-mulch method	newspaper-and-mulch method
nigra juglan	juglans nigra
nih	nih
ninebark	ninebark
nippon daisy	nippon daisy
nitrogen	nitrogen
nitrogen compost activator	nitrogen compost activator
nitrogen-poor lawn	nitrogen-poor lawns
nitrogen-rich leaf	nitrogen-rich leaves
nitrogenous soil	nitrogenous soils
no-dig	no-dig
no-dig gardening	no-dig gardening
no-dig gardening regime	no-dig gardening regime
no-dig gardening system	no-dig gardening systems
no-dig method	no-dig methods
no-dig system	no-dig systems	no-dig system
no-till system	no-till systems
nobili	nobilis
nocturnal	nocturnal
non-european language	non-european languages
non-host	non-host
non-invasive specie	non-invasive species
non-invasive species	non-invasive species
non-native area	non-native areas
non-organic method	non-organic methods
non-selective glyphosate	non-selective glyphosate
non-sheltered location	non-sheltered locations
non-synthetic fertiliser	non-synthetic fertilisers
non-target specie	non-target species
non-target species	non-target species
non-toxic	non-toxic
non-vascular land plant	non-vascular land plants
nonhost foliages	nonhost foliage
nonhost tree foliage	foliage of nonhost trees
nonselective pesticide	nonselective pesticide
normal depth	normal depth
normal potting compost	normal potting compost
northern area	northern areas
norway maple seed	norway maple seeds
noun	noun
nourishment imbibed	nourishment imbibed
nova scotia	nova scotia
nova scotia west	nova scotia west
noxious weed	noxious weed
nugroho	nugroho
number	numbers
numerous capitula	numerous capitula
numerous capitulum	numerous capitula
numerous cultivar	numerous cultivars
numerous macrospecy	numerous macrospecies
numerous minute seed	numerous minute seeds
numerous purple	numerous purple
numerous seed	numerous seeds
numerous seed mix	numerous seed mixes
numerous small seed	numerous small seeds
numerous stamen	numerous stamens
numerous thorn	numerous thorns
numerous tiny male	numerous tiny male
numerous tiny seed	numerous tiny seeds
numerous variety	numerous varieties
numerous yellowish stamen	numerous yellowish stamens
nutritional benefit	nutritional benefit
nutritional value	nutritional value
nyad	nyads
nymphal characteristic	nymphal characteristics
object	objects
objective	objective
oblonge reddish	oblonge reddish
oceanic trench	oceanic trenches
ocelli	ocelli
ocrea	ocreas
ocular	ocular
odoratum	odoratum
officinali	officinalis
ogon	ogon
oil neem contenting	oil neem content
oil neem processing	oil neem process
oil-and-herb sauce	oil-and-herb sauce
oilcake	oilcake
oils	oil
ok	ok
older variety	older varieties
olive family oleaceae	olive family oleaceae
olive oil	olive oil
ombú	ombú
on-line resource	on-line resources
one	ones
onion / s	onion/s
onion/s	onion/s
only administrator	only administrators
onopordum acanthium	onopordum acanthium
ontario	ontario
oomycete	oomycetes
oomycete plant pathogen	oomycete plant pathogens
oomycte	oomyctes
oospore	oospores
open-field	open-field
opening seed capsule	opening seed capsules
operation	operations
opportinistic organism	opportinistic organisms
opportunistic specie	opportunistic species
opportunistic species	opportunistic species
optimal germination	optimal germination
option	options
opulu	opulus
oral	oral
oral folklore	oral folklore
orange / yellow marking	orange / yellow markings
orange hindleg scale	orange hindleg scales
orange swallow-wort	orange swallow-wort
orange-red	orange-red
orange-red bark	orange-red bark
orange-red leaf	orange-red leaves
orange/yellow marking	orange/yellow markings
orchard tree	orchard trees
order	orders
order hemiptera homopterous division	homopterous division of the order hemiptera
order hymenoptera	order hymenoptera
order uredinale	order uredinales
orders	order
organ	organ	organs
organic	organic
organic content	organic content
organic farming bio-pesticide	bio-pesticide for organic farming
organic fertilizer	organic fertilizer
organic form	organic form
organic garden	organic garden	organic gardens
organic gardener	organic gardener	organic gardeners
organic gardener key belief	key belief of the organic gardener
organic gardening	organic gardening
organic growing practice	organic growing practices
organic horticulture	organic horticulture
organic ipm program	organic ipm program
organic lawn	organic lawns	organic lawn
organic lawn care	organic lawn care
organic lawn care organic gardening	organic gardening organic lawn care
organic lawn care organic pesticide	organic lawn care organic pesticides
organic mater	organic mater
organic material	organic material
organic matter	organic matter
organic method	organic methods
organic mulch	organic mulch	organic mulches
organic pesticide	organic pesticides
organic pesticide organic lawn care	organic lawn care organic pesticides
organic practice	organic practices
organic treatment	organic treatment
organic weed control	organic weed control
organic weed management	organic weed management
organism	organism	organisms
organism form	organism forms
organs	organ
original alkaloid	original alkaloids
original nursery	original nursery
origins	origin
ornamental	ornamentals
ornamental cultivar	ornamental cultivars
ornamental garden plant	ornamental garden plant
ornamental plant	ornamental plant	ornamental plants
ornamental shrub	ornamental shrubs
ornamental specie	ornamental species
ornamental species	ornamental species
ornamental tree	ornamental tree	ornamental trees
orthoptera suborder caelifera	suborder caelifera of the orthoptera
osage orange	osage orange
other cultivar	other cultivars
other related specie	other related species
other related species	other related species
other specie	other species
other species	other species
oubliez pa	oubliez pas
ought	ought
ous	ocelli
outbreak	outbreaks
outcrossing	outcrossing
ovali	ovalis
ovary	ovary
ovate	ovate
over-large seed	over-large seed
overcrowded tree	overcrowded trees
overdose	overdose
overpruned tree	overpruned trees
overwinter	overwinters
overwintering	overwintering
overwintering body	overwintering bodies
overwintering bud	overwintering buds
overwintering stage	overwintering stage
oviposit	oviposit
ovipositor	ovipositor	ovipositors
ovoid burr	ovoid burr
ovoid nymph	ovoid nymphs
owner	owners
oxalic acid	oxalic acid
oxygen	oxygen
p. latus	p. latus
p. latus reduced density	reduced densities of p. latus
p. pallidu	p. pallidus
p. pallidus	p. pallidus
packera obovata	packera obovata
packets label	packets labels
paeonia obovata	paeonia obovata
page structure	page structures
pair	pairs
pair--	pair--
pair-- "optical tentacles	pair--
paired samara	paired samaras
pallidu	pallidus
palmate leaf	palmate leaves
palmate lobe	palmate lobes
palmately lobed	palmately lobed
palmately veined	palmately veined
panicle	panicles
pansy monkeyflower	pansy monkeyflower
pansy symbol	pansy symbol
paper barrier	paper barrier
paper birch	paper birch
paper mulch barrier	paper mulch barriers
paper mulch barriers paulownia tomentosum	paper mulch barriers paulownia tomentosa
paperbark maple	paperbark maple
papery layer	papery layers
pappus	pappus
paraguay	paraguay
parasite	parasites
parasitic fly	parasitic fly
parasitic form	parasitic forms
parasitic insect	parasitic insects
parasitic lifestyle exhibit	exhibit parasitic lifestyles
parasitic mite	parasitic mites
parasitic nematode	parasitic nematodes
parasitic wasp	parasitic wasps
parasiticide	parasiticide
parasitize	parasitize
parasitize insect	parasitize insects
parasitize insect entomopathogenic nematode	entomopathogenic nematodes parasitize insects
parasitoid	parasitoids
paratisise plant root	paratisise plant roots
parenchyma	parenchyma
parental care	parental care
part	parts
part loam	part loam
part shade	part shade
parthenocaptic tendency	parthenocaptic tendencies
parthenogenetic	parthenogenetic
particulate	particulate
passage	passages
passing animal	passing animals
passive control	passive control
passive dispersal	passive dispersal
pathogen	pathogens
pathogen specie	pathogen species
pathogen species	pathogen species
pathogenic bacterium	pathogenic bacteria
pathogenic fus	pathogenic fungi
pathogenic organism	pathogenic organisms
pathogenicity factor	pathogenicity factors
pattern	patterns
pattern favoured	pattern favoured
paulownia	paulownia
paulownia tomentosa	paulownia tomentosa
paulownia tomentosa paper mulch barrier	paper mulch barriers paulownia tomentosa
paulownia tomentosum	paulownia tomentosa
pea / s	pea/s	pea / s
pea/s	pea/s
pearl-like object	pearl-like objects
pediculocide	pediculocide
pemanently greenish	pemanently greenish
pemmican	pemmican
pennsylvania	pennsylvania
pennsylvania blackberry	pennsylvania blackberry
pennsylvania site	pennsylvania site
pensilvanicu	pensilvanicus
people	people
peptide	peptides
perdo	perdo
perennial	perennial
perennial bulb	perennial bulb
perennial creeper	perennial creeper
perennial flowering plant	perennial flowering plant
perennial grass	perennial grass
perennial herb	perennial herb
perennial herbaceous plant	perennial herbaceous plants
perennial native	perennial native
perennial plant	perennial plant	perennial plants
perennial plant species	species of perennial plants
perennial specie	perennial species
perennial species	perennial species
perennial weed	perennial weeds
perennial weed root	perennial weed roots
period	periods
periodic mowing	periodic mowing
permaculture	permaculture
permaculture smartweed	permaculture smartweeds
permaculture system	permaculture systems
pernicious perennial	pernicious perennials
persian	persian
personal possession	personal possessions
pest	pests	pest(s)
pest insect	pest insects
pest nematode	pest nematodes
pesticide	pesticides
pesto	pesto
petiola	petiole
petiole	petioles	petiole
ph	ph
ph check	ph check
ph level	ph levels
ph-balanced soil	ph-balanced soil
phacelia	phacelia
pharmacological usage	pharmacological usage
phenylalanine	phenylalanine
pheromone	pheromone	pheromones
pheromone trail	pheromone trails
pheromone trap	pheromone traps
philadelphia	philadelphia
phloem	phloem
phloem vessel	phloem vessels	phloem vessel
phlox paniculata	phlox paniculata
phlox stolonifera	phlox stolonifera
phlox stolonifus	phlox stolonifera
phlox subulata	phlox subulata
phlox subulatum	phlox subulata
phosphate	phosphate
phosphorous rich neck band bridge	phosphorous rich neck band bridges
photodamage	photodamage
photosynthetic capability	photosynthetic capability
phthorá	phthorá
phyla	phyla
phyllary	phyllaries
phylloxera	phylloxera
phylloxeridae family	phylloxeridae family
phylloxus	phylloxera
phylum nematoda	phylum nematoda
physical barrier	physical barrier
physical method	physical methods
physical removal	physical removal
physocarpus	physocarpus
phytohormone	phytohormones
phytonemus	phytonemus
phytoparasitic nematode specie	phytoparasitic nematode species
phytoparasitic nematode species	phytoparasitic nematode species
phytopathogenic fungi	phytopathogenic fungi
phytopathogenic fus	phytopathogenic fungi
phytopathology	phytopathology
phytopathology phytophthora infestan	phytopathology phytophthora infestans
phytophthora	phytophthora
phytoplasma	phytoplasma
phytopthora	phytopthora
phytoseiid mite	phytoseiid mites
phytotoxic cis-cinnamoyl glucoside	phytotoxic cis-cinnamoyl glucosides
phytón	phytón
pickup truck	pickup trucks
pieridae family	pieridae family
pigweed	pigweed
pilea pumila	pilea pumila
pilewort	pilewort
pillow	pillows
pine branch	pine branches
pine sawfly	pine sawflies
pine wood nematode	pine wood nematode
pinnately compound	pinnately compound
pinnately dissected	pinnately dissected
pinnately lobed	pinnately lobed
pinnatifid leaf	pinnatifid leaves
pinnatifid shaped	pinnatifid shaped
pioneer plant	pioneer plant
pioneer specie	pioneer species
pioneer species	pioneer species
pitcher plant	pitcher plants
pitchfork	pitchfork
place	places
placed shoot	placed shoots
planidium	planidium
plant	plants
plant / square	plant/square
plant apoplast	plant apoplast
plant cell membrane invaginate	plant cell membrane invaginates
plant debris over-winter	plant debris over-winter
plant disease	plant diseases
plant family rosaceae	plant family rosaceae
plant growth	plant growth
plant pathogen	plant pathogens
plant pathogenic bacterium	plant pathogenic bacteria
plant pathogenic fungi	plant pathogenic fungi
plant pathogenic fus	plant pathogenic fungi
plant pathogenic organism	plant pathogenic organism
plant prune	plant pruning
plant root	plant roots
plant specie	plant species
plant species	plant species
plant virus	plant viruses
plant-growth inhibition characteristic	plant-growth inhibition characteristics
plant/square	plant/square
plantaginaceae	plantaginaceae
plantago family	plantago family
plantain	plantain
planthopper	planthoppers
planting	plantings
planting area	planting area
planting technique	planting techniques
plants	plant
plasmodium	plasmodium
plastic bag	plastic bags
plastic film	plastic films
plastic mulch	plastic mulch
platanoide	platanoides
platy	platy
play area	play areas
playground feature	playground features
plenatd	plenatd
pleurisy root	pleurisy root
pod	pods
point	points
pointing hook	pointing hooks
poisonous tree	poisonous tree
poke salit	poke salit
pokeberry	pokeberry
pokebush	pokebush
pokeroot	pokeroot
pokeweed	pokeweeds	pokeweed
pokeweed berry	pokeweed berries
polar region	polar regions
pollarded tree	pollarded trees
pollen	pollen
pollen allergy	pollen allergies
pollen production	pollen production
pollenating insect	pollenating insects
pollination	pollination
pollination mark	pollination mark
pollinator	pollinators
pollutant	pollutants
polygonatum multiflorum	polygonatum multiflorum
polygonatum odoratum	polygonatum odoratum
polygonatum verticillatum	polygonatum verticillatum
polygonum perfoliatum	polygonum perfoliatum
polyphagotarsonemus	polyphagotarsonemus
polyphyletic group	polyphyletic group
polyploidy	polyploidy
polythene	polythene
pom	pomes
pome	pomes
pontus	pontus
popeye cartoon	popeye cartoons
poppy	poppy
poppy family native	poppy family native
poppywort	poppywort
popular confusion	popular confusion
popular flavoring	popular flavoring
popular landscape shrub	popular landscape shrub
popular ornamental plant	popular ornamental plant
popular ornamental shrub	popular ornamental shrubs
popular ornamental tree	popular ornamental tree
popular pastime	popular pastime
popular wood	popular wood
population	populations
population number	population numbers
populations increase	populations increase
porcelain exporter	porcelain exporters
positive quality	positive qualities
possession	possessions
possible hazard	possible hazard
postpartum anemia	postpartum anemia
postwood crop	postwood crop
potash	potash
potassium sulphide	sulphide of potassium
potassiums	potassium
potato	potatoes
potato chip	potato chips
potato root nematode	potato root nematode
potential enemy	potential enemies
potential nutraceutical value	potential nutraceutical value
potential predator	potential predators
potential spread	potential spread
powder form	powder form
powder-like spot	powder-like spots
power mower	power mowers
practice	practices
pre-emergence herbicide	pre-emergence herbicide
pre-emergent	pre-emergent
pre-emergent herbicide	pre-emergent herbicides
pre-emergent used	pre-emergent used
pre-glacial population	pre-glacial populations
predaceou diving beetle	predaceous diving beetles
predaceous diving beetle	predaceous diving beetles
predaciou	predacious
predation	predation
predator	predators
predatory beetle	predatory beetles
predatory mite	predatory mites
predatory nematode	predatory nematodes
predatory one	predatory ones
predatory phytoseiid mite	predatory phytoseiid mites
predatory wasp	predatory wasps
preparation	preparation	preparations
preparing cosmetic	preparing cosmetics
preservative property	preservative properties
preserving soil structure	preserving soil structure
pressure	pressures
preventing branch	preventing branches
preventing disease	preventing diseases
preventing flower	preventing flowers
preventing seed	preventing seeds
prey requirement	prey requirements
primary branch	primary branches
primary contributing factor	primary contributing factors
primary diet	primary diet
primary infectious agent	primary infectious agent
primary reason	primary reasons
primary signal	primary signal
primitive taxa	primitive taxa
primorsky krai	primorsky krai
princess tree	princess tree
principal lifecycle beetle stages	principal lifecycle beetle stage
problem	problems
problem weed specie	problem weed species
problem weed species	problem weed species
problem-free	problem-free
problematic invasive specie	problematic invasive species
problematic invasive species	problematic invasive species
proceeds	proceeds
process	processes
process incorporating temperature control	process incorporating temperature controls
procumbent yellow sorrel	procumbent yellow sorrel
produce unmarketable	produce unmarketable
producing cultivar	producing cultivars
product	products
productive plant	productive plants
professional supervision	professional supervision
profit	profits
program	programs
program return	program returns
progressive moult	progressive moults
project scope	project scope
proleg	prolegs
proliferation	proliferation
prolific seeder	prolific seeder
prolific seedling	prolific seedlings
pronotum	pronotum
pronunciation	pronunciation
propaganda purpose	propaganda purposes
propagation method	propagation methods
property	properties
protective clothing pruning	protective clothing pruning
protein	protein
protist	protists
protozoa	protozoa
protozoan	protozoans	protozoa
provençal name	provençal name
providing aeration	providing aeration
providing incentive	providing incentives
proximal part	proximal part
prune	pruning
prune lateral	prune laterals
pruning okame cherry	pruning okame cherry
prunu	prunus
prunu virginiana	prunus virginiana
prunus	prunus
prunus laurocerasu	prunus laurocerasus
prunus laurocerasus	prunus laurocerasus
prunus virginiana	prunus virginiana
pseudococcidae	pseudococcidae
psilostachya	psilostachya
psyllid	psyllids
psyllium seed	psyllium seeds
pubescence	pubescence
public awareness	public awareness
publication	publications
puccinia gramini	puccinia graminis
pulling weed	pulling weeds
pulmonary edema	pulmonary edema
pulmonary edemum	pulmonary edema
pumping movement	pumping movements
pupa	pupae
pupal	pupal
pupal stage	pupal stage
pupation	pupation
pure stand	pure stands
purple loosestrifa	purple loosestrife
purple loosestrife	purple loosestrife
purple loostrife	purple loostrife
purple raspberry	purple raspberries
purple-foliage cultivar	purple-foliage cultivars
purpose	purposes
putting plant	putting plants
pyracantha	pyracantha	pyracanthas
pyracantha berry	pyracantha berries
pyrrolizidine alkaloid	pyrrolizidine alkaloids
pythium	pythium
quality	qualities
quality seed	quality seeds
quality vegetable	quality vegetables
quantity	quantities
quarantine site	quarantine site
quassia family	quassia family
quebec	quebec
quebec west	quebec west
quorum	quorum
racemose panicle	racemose panicles
radial growth	radial growth
radial growth reduction	radial growth reduction
radical change	radical change	radical changes
radula	radula
ragweed	ragweeds	ragweed
ragweed eradications	ragweed eradication
ragweed extermination	ragweed extermination
ragweed flower	ragweed flowers
ragweed hyper-sensitivity	ragweed hyper-sensitivity
ragweed pollen	ragweed pollen
ragweed pollen allergy	ragweed pollen allergies
ragweed total eradication	total eradication of ragweed
ragwort	ragwort
rai	rai
railroad track	railroad tracks
rainfall area	rainfall areas
raised brick-red spot	raised brick-red spots
rancid cashew	rancid cashews
range	ranges
range area	range areas
range/grassland	range/grasslands
rangeland	rangeland
ranunculus ficaria	ranunculus ficaria
rapid growth	rapid growth
rapid zigzag pattern	rapid zigzag patterns
rarer cultivar	rarer cultivars
raspberry	raspberries
raspberry cultivar	raspberry cultivars
raspberry fruit	raspberry fruit
raspberry production	raspberry production
rate	rates
ray floret	ray florets
rayle	rayless
rayles	rayless
reaching height	reaching heights
reaching light	reaching light
real-world bookshelf	real-world bookshelf
reason	reasons
rebloom	rebloom
reblooming	reblooming
recent attempt	recent attempts
recent classification	recent classification
recent study	recent studies
recreational vehicle	recreational vehicles
recruitment trail	recruitment trails
red-brown	red-brown
red-orange	red-orange
reddish-black seed	reddish-black seed
reddish-brown	reddish-brown
reddish-purple	reddish-purple
reducing heat loss	reducing heat loss
reducing pain	reducing pain
reducing stress	reducing stress
reductive pruning	reductive pruning
reflexed downward	reflexed downward
refoliation	refoliation
refrigeration	refrigeration
refrigerator	refrigerator
refrigerator crisper tray	crisper tray of the refrigerator
refrigerator trays	refrigerator tray
refrigerators	refrigerator
regarding nutrition	regarding nutrition
regeneration	regeneration
region	regions
regional variation	regional variation
regrowth	regrowth
regular deadheading	regular deadheading
regular interval	regular intervals
regular mowing	regular mowing
regular raking	regular raking
regular straw	regular straw
regular use	regular use
regular watering	regular watering
regulating humidity	regulating humidity
regulatory system	regulatory system
related specie	related species
release aeciospore	release aeciospores
release spore	release spores
release spore overwintering body	overwintering bodies release spores
rem red	rem red
remarka	remarka
removing flower	removing flowers
removing obstruction	removing obstructions
removing tissue	removing tissue
removing weed	removing weeds
replicase	replicase
reported indication	reported indications
representative	representative
reproduction	reproduction
reproductive organ	reproductive organs
reproductive system	reproductive systems
reptan	reptans
reptilian scale	reptilian scales
requirement	requirements
research beginning	research beginning
reserve	reserves
resistant variety	resistant varieties
resource	resources
resource forest	resource forest
respiration	respiration
respiratory disease	respiratory diseases
respiratory phlegm	respiratory phlegm
respiratory system	respiratory systems
result	results
retaining air	retaining air
retaining wall	retaining walls
retrorsine	retrorsine
return	returns
returned profit	returned profits
rfa process	rfa process
rheumatic disorder	rheumatic disorders
rheumatism	rheumatism
rheumatoid arthritis	rheumatoid arthritis
rhizomatous growth form	rhizomatous growth form
rhododendron stock	rhododendron stock
rhu	rhus
rhu glabra	rhus glabra
rhu typhina	rhus typhina
rhus glabra	rhus glabra
rhus typhina	rhus typhina
rhythmic muscular action	rhythmic muscular action
rich neck band bridge	rich neck band bridges
richweed	richweed
riddelline	riddelline
right	rights
ring	rings
ringspot	ringspot
riparian habitat	riparian habitats
riparian zone	riparian zones
rise	rises
risk	risks
riverton	riverton
rna genome	rna genomes
road cut	road cuts
road shoulder	road shoulders
road side	road sides
roasted dandelion root	roasted dandelion root
rocketcre	rocketcress
rocketcres	rocketcress
rocky	rockies
rod	rods
root	roots
root barrier	root barriers
root cell	root cells
root cutting	root cuttings
root feeder	root feeders
root fragment	root fragments
root hair	root hair
root knot nematode	root knot nematodes
root level	root level
root mass	root mass
root rot	root rot
root sprout	root sprouts
root sucker	root suckers
root system	root system	root systems
root vicinity	root vicinity
root zone barrier	root zone barriers
root-bark	root-bark
root-form	root-forms
root-knot nematode	root-knot nematodes	root-knot nematode
root-structure	root-structure
root-weed	root-weeds
rootbound	rootbound
rootlet	rootlets
rootstock	rootstock
rorippa sylvestri	rorippa sylvestris
rosa multiflora	rosa multiflora
rot	rots
rotation	rotation
rotten tree	rotten trees
roughley	roughley
roundworm	roundworms	roundworm
row	rows
row cover	row covers
royal newfoundland regiment	royal newfoundland regiment
rubu	rubus
rubu idaeu	rubus idaeus
rubu leucodermi	rubus leucodermis
rubu occidentali	rubus occidentalis
rubu strigosu	rubus strigosus
rubus	rubus
rubus idaeus	rubus idaeus
rubus leucodermi	rubus leucodermis
rubus occidentali	rubus occidentalis
rubus pensilvanicu	rubus pensilvanicus
rubus pensilvanicus	rubus pensilvanicus
rubus strigosus	rubus strigosus
ruderal place	ruderal places
ruderal site	ruderal sites
running plant	running plants
running weed	running weeds
russia	russia
rust fungi	rust fungi
rust fus	rust fungi
rěn dōng téng	rěn dōng téng
saccharum	saccharum
saihō-ji	saihō-ji
salad burnet	salad burnet
salicaire	salicaire
salicylic acid	salicylic acid
salicylic acid derivative	salicylic acid derivatives
saline soil	saline soils
salivary gland origin	salivary gland origin
salt	salt
salt tolerance	salt tolerance
salvia guaranitica	salvia guaranitica
salvia guaraniticum	salvia guaranitica
samara	samaras	samara
san jose scale	san jose scale
saponin	saponins
saprotroph	saprotrophs
sapwood	sapwood
sarracenia	sarracenia
sarvisberry	sarvisberry
saskatchewan	saskatchewan
saskatoon	saskatoon
saskatoon berry	saskatoon berry
sawfly	sawflies
sawfly larva	sawfly larvae
scale	scales
scale insect	scale insects
scale insect species	species of scale insects
scale specie	scale species
scale species	scale species
scaling	scale
scandinavia	scandinavia
scape	scape
scarabaeiform	scarabaeiform
scarabaeoidea	scarabaeoidea
scarabaeoideum	scarabaeoidea
scenario	scenarios
scent	scents
schwedleri	schwedleri
scientific institution	scientific institutions
scientific literature	scientific literature
scientific research	scientific research
scientific study	scientific studies
scilla	scilla
sclerotia organism form	organism forms sclerotia
sclerotium	sclerotium
scorpioide	scorpioides
scottish thistle	scottish thistle
scottish village	scottish villages
scrub / shrubland	scrub / shrublands
scrub/shrubland	scrub/shrublands
scurvy	scurvy
scurvywort	scurvywort
scutellum	scutellum
sea level	sea level
season grass	season grasses
secondary branch	secondary branches
secondary importance	secondary importance
secondary shoot	secondary shoots
secondary soft bacterial rot	secondary soft bacterial rots
secretion	secretion
section	sections
section incluse	section incluse
security quality	security qualities
sedative	sedative
seed	seeds
seed bank	seed banks
seed banking	seed banking
seed borer	seed borers
seed cake	seed cake
seed capsule	seed capsules
seed catalog	seed catalogs
seed dispersal phase	seed dispersal phase
seed dormancy	seed dormancy
seed drill	seed drill
seed head	seed heads
seed kernel	seed kernel
seed mix	seed mixes
seed packets label	seed packets labels
seed plant	seed plant
seed pod	seed pods
seed potato	seed potato
seed problem	seed problems
seed production	seed production
seed productivity	seed productivity
seed rate	seed rate
seed set	seed sets
seed stock	seed stock
seed-plant	seed-plant
seed-potato	seed-potatoes
seeder	seeder
seeds / hectare	seeds/hectare
seeds fall	seeds fall
seeds/hectare	seeds/hectare
seeking help	seeking help
segment	segments
segmentation	segmentation
segmented grey / black body	segmented grey/black body
segmented grey/black body	segmented grey/black body
selborne	selborne
selection program	selection programs
selective filtering	selective filtering
self-fertilise	self-fertilise
self-fertilised seed	self-fertilised seed
self-seed	self-seeds	self-seed
self-sow	self-sows
semester course	semester course
semi-aquatic herbaceous plant	semi-aquatic herbaceous plant
semi-evergreen	semi-evergreen
semi-translucent berry	semi-translucent berry
semi-transparent	semi-transparent
semperviren	sempervirens
senecio	senecio
senecio jacobaea	senecio jacobaea
senecionine	senecionine
seneciphylline	seneciphylline
senecivernine	senecivernine
sensitive area	sensitive areas
sensitive organic gardener	sensitive organic gardener
sensory landscape	sensory landscape
serious damage	serious damage
serious disease	serious diseases	serious disease
serious ecological problem	serious ecological problem
serious fungal disease	serious fungal disease
serious infestation	serious infestation
serious invasive	serious invasives
serious invasive specie	serious invasive species
serious invasive species	serious invasive species
serious issue	serious issue
serious pest	serious pest	serious pests
serious problem	serious problems	serious problem
serious threat	serious threat
serration	serrations
service branch	service branches
serviceberry	serviceberry	serviceberries
sesiid moth diurnal species	diurnal species of sesiid moth
sessile	sessile
sessile leaf	sessile leaves
set	sets
setaceous hebrew character	setaceous hebrew character
setae	setae
setaria	setaria
settlement / agriculture	settlement/agriculture
settlement/agriculture	settlement/agriculture
severe infection	severe infections
severe infestation	severe infestations
sewer	sewers
sex chromosome	sex chromosomes
sexual	sexual
sexual female	sexual females
sexual individual	sexual individuals
sexual male	sexual males
sexual maturity	sexual maturity
sexual-apomictic	sexual-apomictic
shadblow	shadblow
shadbush	shadbush	shadbushes
shadbush fruit	shadbush fruits
shade garden	shade gardens
shade lawn	shade lawns
shade tolerance	shade tolerance
shade tree	shade tree	shade trees
shadwood	shadwood
shady spot	shady spots
shallowly grooved	shallowly grooved
shandong maple	shandong maple
shape change	shape changes
shell	shells
shewell cooper	shewell cooper
shoot	shoots
shoot growth	shoot growth
shoot hemlock tender saps	shoot hemlock tender sap
shoot node	shoot node
shop	shops
shoulder	shoulders
shredder	shredder
shrub	shrubs	shrub
shrub-like perennial	shrub-like perennial
shrubland	shrublands
siberia	siberia
siberian squill	siberian squill
side	sides
side branch	side branches
side inter-row	side inter-rows
side petal	side petals
side shoot	side shoots
side shoot production	side shoot production
side tooth	side teeth
sidebar	sidebar
significant abiotic disorder	significant abiotic disorders
significant abiotic disorder significant bacterial plant pathogen	significant bacterial plant pathogens significant abiotic disorders
significant bacterial plant pathogen	significant bacterial plant pathogens
significant fungal plant pathogen	significant fungal plant pathogens
significant oomycete plant pathogen	significant oomycete plant pathogens
significant oomycete plant pathogen significant fungal plant pathogen	significant fungal plant pathogens significant oomycete plant pathogens
silique	silique
silk trail	silk trails
silkworm	silkworms
silky swallow-wort	silky swallow-wort
silverbeet	silverbeet
simaroubaceae	simaroubaceae
site	sites
situ	situ
sixteen / square	sixteen/square
sixteen/square	sixteen/square
sixth-instar caterpillar	sixth-instar caterpillar
skeletonize leaf	skeletonize leaves
skeletonized leaf	skeletonized leaves
slug	slugs
small seed	small seeds
smallpox	smallpox
smartweed	smartweeds
snuff	snuff
soapwort	soapwort
soapwort bloom	soapwort blooms
social caterpillar species	species of social caterpillars
social specie	social species
social species	social species
soil	soils
soil acidification	soil acidification
soil acidity	soil acidity
soil condition	soil conditions
soil consition	soil consitions
soil damaging	soil damage
soil flora damage balance	damage balances of the soil flora
soil fungi	soil fungi
soil fus	soil fungi
soil improvement soil solarization	soil improvement soil solarization
soil solarization soil	soil solarization soil
soil-borne fungus	soil-borne fungus
soil-bound glyphosate	soil-bound glyphosate
soil-bound larva	soil-bound larvae
soiling	soil
solanaceae	solanaceae
somethat drought	somethat drought
somme	somme
sonoran desert	sonoran desert
sorbus	sorbus
sorrel	sorrel
source	sources
source material	source materials
sourwood	sourwood
sowing spinach	sowing spinach
sown	sown
sparse understory	sparse understory
spartioidine	spartioidine
spathe	spathe
specie	species
species	species
species count	species counts
species damage sugarcane	species damage sugarcane
species drop	species drop
species exhibit leaf-mining	species exhibit leaf-mining
species form	species forms
species name	species names
species name maackii	species name maackii
species overwinter	species overwinters
species share	species share
species use slime cord	species use slime cords
specimen	specimens
speculation	speculations
specy	species
speed recovery	speed recovery
spider mite	spider mites
spine	spine
spinneret	spinneret
spiracle	spiracles
spiraea	spiraea
spiraea douglasii	spiraea douglasii
spiraea thunbergii	spiraea thunbergii
spiraea tus	spiraea thunbergii
sporangia	sporangia
spore	spores
spore asexual processing	spore asexual process
spore land	spore lands
spores	spore
sporulation	sporulation
spot	spots
spp	spp
spp.	spp
spray	sprays
spreading shrub	spreading shrub
spring tiphia	spring tiphia
spring tiphon	spring tiphia
spur bearing	spur bearing
sq ft	sq ft
squarish	squarish
squarish lobe	squarish lobes
st	st
st.	st
stage	stages
staggerwort	staggerwort
staghorn sumac	staghorn sumac
stammerwort	stammerwort
stand	stands
standalone plastic mulch layer	standalone plastic mulch layer
standard application	standard applications
state	states
state law	state laws
state tree	state tree
stating	state
statutory obligation	statutory obligation
staunchweed	staunchweed
steam distillation	steam distillation
stem	stems
steneotarsonemeus	steneotarsonemeus
sterilizing soil	sterilizing soils
sternorryncha	sternorryncha
steroidogenic acute regulatory	star
steroidogenic acute regulatory protein	steroidogenic acute regulatory protein
sterol	sterols
stewartstown	stewartstown
sticktight	sticktight
stigmasterol	stigmasterol
stigmata	stigmata
stimulant effect	stimulant effect
stink bug	stink bugs
stinktree	stinktree
stolon	stolons
stoloniferou	stoloniferous
stolonifus	stolonifera
stomach sickness	stomach sickness
stomata	stomata
stomatal lip	stomatal lips
stonefly	stoneflies
stop bleeding	stop bleeding
storage time	storage time
store	stores
storing water	storing water
storm sewer	storm sewers
stramenopila	stramenopila
stramenopile	stramenopiles
stramenopile cell wall	stramenopile cell walls
strategy	strategies
strawberry	strawberries
stream bank	stream banks
stream margin	stream margins
stressful	stressful
strigosu	strigosus
string-trimmer	string-trimmer
stripe	stripes
structural branch	structural branches
structure	structures
student	students
study	studies
stuff pillow	stuff pillows
stump	stumps
stylophorum	stylophorum
suaveolen	suaveolens
sub-continent	sub-continent
sub-species	sub-species
subcategory	subcategories
subclass acarina	subclass acarina
subject	subject
suborder	suborders	suborder
suborder apocrita	suborder apocrita
suborder symphyta	suborder symphyta
subpage-style link	subpage-style links
subpage-style links	subpage-style links
subshrub	subshrubs	subshrub
subsp	subsp
subsp.	subsp
subspecies name	subspecies name
subspecy	subspecies
substance	substances
subulatum	subulata
success rate	success rate
successional habitat	successional habitats
sucker	suckers
suckering	suckering
suckering shrub	suckering shrub
sugar ash	sugar ash
sugar maple	sugar maple	sugar maples
sugar maple bark	sugar maple bark
sugar maple leaf	sugar maple leaves
sugar maple subspecy	subspecies of sugar maple
sugar maple-american basswood	sugar maple-american basswood
sugar maple-ironwood-red oak	sugar maple-ironwood-red oak
sugar maple-white ash	sugar maple-white ash
sugar maple-yellow birch	sugar maple-yellow birch
sugar transporter	sugar transporters
sugaring	sugar
sugarplum	sugarplum
sugary honeydew secreted	sugary honeydew secreted
sulfur	sulfur
sulphides	sulphide
sulphosat-based	sulphosat-based
sumac specie	sumac species
sumac species	sumac species
sunflower family	sunflower family
sunny location	sunny locations
superfamily aphidoidea	superfamily aphidoidea
superfamily aphidoideum	superfamily aphidoidea
superfamily artificial assemblage	artificial assemblage of superfamilies
superfamily assemblages	superfamily assemblage
superfamily coccoidea	superfamily coccoidea
superweed	superweed
suppressive hormone	suppressive hormone
surface named sus	surface named siphunculi
surfactant	surfactants
surfactant polyoxy-ethyleneamine	surfactant polyoxy-ethyleneamine
surrounding region	surrounding regions
surrounding tissue	surrounding tissue
sus	siphunculi
svb	svb
swamp cabbage	swamp cabbage
swamp cabbage " ( symplocarpus foetidus )	swamp cabbage
sweetgum	sweetgum
sweetpotato whitefly-strain b	sweetpotato whitefly-strain b
sylvestri	sylvestris
symbiont	symbionts
symbol	symbol
symbols	symbol
symptom	symptoms	symptom
syn	syns	syn
synonym	synonyms
synonymous name	synonymous name
synthetic chemical	synthetic chemicals
synthetic chemical input	synthetic chemical inputs
synthetic fertilizer	synthetic fertilizers
synthetic herbicide	synthetic herbicides
synthetic material	synthetic materials
synthetic mulch	synthetic mulches
syringa vulgari	syringa vulgaris
system	systems
systematic	systematics
systemic brand name	brand name of a systemic
systemic herbicide	systemic herbicides	systemic herbicide
systemic naming	systemic name
t / ha	t/ha
t/ha	t/ha
tachinid fly moving target	moving target for tachinid flies
tahini halva commercial preparation	commercial preparation of tahini halva
taii	taii
tail tearthumb	tail tearthumb
taiwan	taiwan
talk page	talk page
tanbark	tanbark
tannin	tannin
tansy ragwort	tansy ragwort
taptoot	taptoot
taraxacum	taraxacum
tarsal segment	tarsal segment
tarsonemid genus	tarsonemid genera
tarsonemid mite	tarsonemid mites
tarsonemid specie	tarsonemid species
tarsonemid species	tarsonemid species
tarsonemidae	tarsonemidae
tarsonemus	tarsonemus
tasmania	tasmania
taste astringency	taste astringency
tatarian aster	tatarian aster
taxon	taxon
taxonomically significant	taxonomically significant
taxonomies	taxonomy
taxonomy	taxonomy
teleomorph	teleomorph
temperate-region garden	temperate-region gardens
temperature condition	temperature conditions
temperature control	temperature controls
temperature excess	temperature excesses
temperaturre regulation	temperaturre regulation
template	template
tenacious weed regular inspection	regular inspection for tenacious weeds
tendency	tendencies
tender hemlock shoot phloem sap	phloem sap of tender hemlock shoots
tender shoots	tender shoot
tendering	tender
tenebrionidae	tenebrionidae
term process	term process
terminal panicle	terminal panicles	terminal panicle
terpenes citronellal	terpenes citronellal
terrestrial environment	terrestrial environments
terrestrial specie	terrestrial species
terrestrial species	terrestrial species
test system	test systems
testosterone production	testosterone production
tetanus	tetanus
tetranychu	tetranychus
tetranychu urticae	tetranychus urticae
tetranychus urticae	tetranychus urticae
tetraploid apomict	tetraploid apomicts
tetraploid form	tetraploid forms
tetraploid type	tetraploid type
texa	texas
textbook	textbooks
themeselves fall fungal plant pathogen	fungal plant pathogens themeselves fall
therapeutic dose	therapeutic doses
therapeutic purpose	therapeutic purposes
thermal control	thermal control
thermogenesi	thermogenesis
thich	thich
thigmodifferentiation	thigmodifferentiation
thigmotropism	thigmotropism
thimbleberry	thimbleberry
thorax	thorax
thorax " ( see image )	thorax
thorn	thorns
thousand-leaf	thousand-leaf
thousand-seal	thousand-seal
three-leaved maple	three-leaved maple
thrip	thrips
time	times
time consuming	time consuming
time plant kill	time plant kill
time span	time span
time weed	time weeds
tined aerator	tined aerator
tiny seed	tiny seeds
tip	tips
tip bearer	tip bearers
tip bearing	tip bearing
tip bearing shoot	tip bearing shoots
tip bearing variety	tip bearing varieties
tiphon	tiphia
tisane	tisane
tissue	tissues
tomato/e	tomato/es
tomentose	tomentose
tomentose hair	tomentose hairs
tomentosum	tomentosa
tongue-like organ	tongue-like organ
tongued	tongued
toolbox	toolbox
tooth	teeth
tooth-like denticle	tooth-like denticles
tooth-like structure	tooth-like structures
top-selling agrichemical	top-selling agrichemical
topical treatment	topical treatments
topical use	topical use
topsoil	topsoil
torridon	torridon
total damage	total damage
total diversity	total diversity
total loss	total loss
townsfolk	townsfolk
toxic	toxic
toxic breakdown product	toxic breakdown products
toxic material	toxic materials
toxic potential	toxic potential
toxic substance	toxic substances
toxic substance saponin	toxic substance saponin
toxin	toxin
trace	traces
tracheal system	tracheal system
track	tracks
tract	tracts
trade name	trade names
traditional ayurvedic	traditional ayurvedic
trail	trails
trail pheromone	trail pheromone
trail pheromone secreted	trail pheromone secreted
trailing vine	trailing vine
translation	translations
transmission	transmission
transplant	transplant	transplants
transportation	transportation
transporter	transporters
transwiki	transwikis
transwiki-based module	transwiki-based module
transwikiing content	transwikiing content
trap	traps
trap crop	trap crops
trap plant	trap plants
treating fever	treating fevers
treatment	treatments
tree	trees
tree bark	tree bark
tree hardwood pests	tree hardwood pest
tree ring	tree rings
tree root	tree roots
tree specie	tree species
tree species	tree species
tree spider mite	tree spider mites
tree stump	tree stumps
tree trunk	tree trunk
tree-of-heaven	tree-of-heaven
treehopper	treehoppers
trees	tree
trench	trenches
trial	trials
triangle	triangle
triangular shape	triangular shape
tribolium castaneum	tribolium castaneum
triclopyr	triclopyr
triclopyr concentration	concentration of triclopyr
tridentine	tridentine
trifoliate leaf	trifoliate leaves
tripinnate	tripinnate
triterpenoid	triterpenoids
triterpenoid compound	triterpenoid compounds
tromsø	tromsø
tropical area	tropical areas
tropical region	tropical regions
troubleshooting section	troubleshooting sections
truck	trucks
true-bug	true-bugs
trunk	trunk
tryptophan	tryptophan
tsugae	tsugae
tub	tub
tube	tubes
tube-like heart	tube-like heart
tubular base	tubular base
tubular calyx	tubular calyx
tulip-tree	tulip-tree
turf	turf
turfgras	turfgrasses
turfgrass	turfgrasses
turn lead	turn lead
turnery	turnery
tus	thunbergii
twig	twigs
two-celled capsule	two-celled capsule
two-week increment	two-week increments
two-year life cycle	two-year life cycles
type specie	type species
type species	type species
typical sawfly larva	typical sawfly larvae
tyrosine	tyrosine
téng	téng
u. s. pharmacopoeia	u. s. pharmacopoeia
uk	uk
ulcer	ulcers
umbel	umbels
umbellifer	umbellifers
umbrella-shaped cluster	umbrella-shaped clusters
unani	unani
unbranched	unbranched
unbranched stem	unbranched stems
uncinula bicorni	uncinula bicornis
underground structure	underground structures
understory plant	understory plant	understory plants
underwing	underwings
unforked	unforked
uninvaded wetland	uninvaded wetlands
united state	united states
united state mid-atlantic	mid-atlantic united states
united state yearbook	yearbook of the united states
united yearbooks	united yearbook
unprocessed mineral	unprocessed minerals
unproductive foliage	unproductive foliage
unpruned tree	unpruned trees
unsterilized animal manure	unsterilized animal manure
urediniomycota taxonomy	taxonomy of urediniomycota
urinary antiseptic	urinary antiseptic
urinary disorder	urinary disorders
urinary system	urinary systems
ursolic acid	ursolic acid
urticae	urticae
urticaria	urticaria
uruguay	uruguay
usa	usa
usaramine	usaramine
usda	usda
usda hardiness zone	usda hardiness zones
usda no-till	usda no-till
usda plant hardiness zone	usda plant hardiness zones
usda zone	usda zones
use	uses
use category	use categories
use cheshunt	use cheshunt
utah	utah
utilisation	utilisation
utilise fungi mustards	utilise fungi mustard
utility line	utility lines
var	var	vars
var.	var
variegatum	variegatum
variety	varieties
various neem remedying	various neem remedy
various specie	various species
various species	various species
varroa destructor	varroa destructor
varying degree	varying degrees
varying shade	varying shades
vascular system	vascular system	vascular systems
vector	vector
veetable garden	veetable gardens
veganic	veganic
vegetable	vegetables
vegetables outline	vegetables outline
vegetative propagation	vegetative propagation
vegetative tissue	vegetative tissues
vehicle	vehicles
velvet-like	velvet-like
velvetleaf	velvetleaf
ventral side	ventral side
verbena hastata	verbena hastata
verlotiorum	verlotiorum
vermiculite	vermiculite
vernacular scharbockskraut	vernacular scharbockskraut
vertex	vertex
vertical barrier	vertical barriers
vertical row	vertical rows
vertical surface	vertical surfaces
verticillium	verticillium
vessel	vessels
vestigial structure	vestigial structures
viburnum cassinoide	viburnum cassinoides
viburnum dentatum	viburnum dentatum
viburnum dilatatum	viburnum dilatatum
viburnum opulu	viburnum opulus
viburnum opulus	viburnum opulus
viburnum prunifolium	viburnum prunifolium
viburnum trilobum	viburnum trilobum
viewpoint	viewpoint
vigorous growth	vigorous growth
vigorous new growth	vigorous new growth
vigorous young sprout	vigorous young sprouts
viking	vikings
village	villages
vine	vine
vineala	vineale
violet genus	violet genus
violet-gray powder	violet-gray powder
viral vector	viral vectors
virgatum	virgatum
virus	viruses
vitamin c.	vitamin c.
vitiation	vitiation
viviparou	viviparous
viviparous	viviparous
viviparous method	viviparous methods
voracious predator	voracious predators
vulgari	vulgaris
walkway	walkways
wall	walls
walnut	walnut
wand loosestrife	wand loosestrife
war	wars
war commemoration	war commemorations
warming issue	warming issue
wasp	wasps
waste area	waste areas
waste excretion	waste excretion
waste ground	waste grounds
waste place	waste places
wasurenagusa	wasurenagusa
water beetle	water beetles
water mould overwinter	water mould overwinter
waterline	waterline
weakened tree	weakened trees
wearing grass mix	wearing grass mixes
weather condition	weather conditions
weather pattern	weather patterns
web	web
website	website
webworm	webworm
weed	weeds	weed
weed control nimblewill	weed control nimblewill
weed fruit	weed fruits
weed root	weed roots
weed specie	weed species
weed tenacious inspections	weed tenacious inspection
weed-free	weed-free
weed-wacking	weed-wacking
weeding	weed
week	week
weigela florida	weigela florida
weight loss	weight loss
western boxelder	western boxelder
wetland	wetland	wetlands
wetland area	wetland areas
wetland environment	wetland environments
wetland soil	wetland soils
wetland specialist	wetland specialist
wettable powder	wettable powder	wp
whilst parasitoid	whilst parasitoids
whilst shady spot	whilst shady spots
whip	whip
white-root	white-root
whitefly	whiteflies
whitefly-type damage	whitefly-type damage
whitish-green flower	whitish-green flowers
wicca	wicca
wiccum	wicca
width	width
wikibook	wikibooks	wikibook
wikified version	wikified version
wikimanual	wikimanual
wikipedia	wikipedia
wikipedia article	wikipedia article	wikipedia articles
wikipedia article name	wikipedia article name
wikiversity	wikiversity
wild-plum	wild-plum
wilderness area	wilderness areas
wildflower	wildflower	wildflowers
wildflower mix	wildflower mixes
wildflower native	wildflower native
wildland noxious weed problem	wildland noxious weed problem
willamette valley	willamette valley
willelmus dawndelyon	willelmus dawndelyon
wind pollination	wind pollination
wind-pollenated	wind-pollenated
windborne seed	windborne seeds
windroot	windroot
windshield wiper	windshield wipers
windstorm	windstorms
wing	wings
winged form	winged forms
winged seed	winged seeds
wisconsin	wisconsin
witchcraft	witchcraft
wittrockiana	wittrockiana
wood fibre commercial source	commercial source of wood fibre
wood poppy	wood poppy
wood sorrel	wood sorrel
wood-boring beetle	wood-boring beetles
woodchipper	woodchippers
woodland community	woodland community
woodlot	woodlots
woods	wood
woodsorrel	woodsorrel
woolly adelgid	woolly adelgid
woolly adelgid balsam	balsam woolly adelgid
word agermona	word agermone
word agermone	word agermone
worker	workers
world-wide	world-wide
worm	worms
worm-like	worm-like
wormwood	wormwood
wort	wort
wort oil	wort oil
wound	wounds
wound rocket	wound rocket
woundwort	woundwort
wrapping root	wrapping roots
writing	writings
wu wang cao	wu wang cao
wyoming	wyoming
xinjiang	xinjiang
xylem vessel	xylem vessels
year round	year round
yearly seed production	yearly seed production
yellow fieldcre	yellow fieldcress
yellow fieldcres	yellow fieldcress
yellow marking	yellow markings
yellow rocketcre	yellow rocketcress
yellow rocketcres	yellow rocketcress
yellow woodsorrel	yellow woodsorrel
yellow-brown spot	yellow-brown spots
yellow-green	yellow-green
yellow-orange flower	yellow-orange flowers
yellow-orange sap	yellow-orange sap
yellowish-green corolla	yellowish-green corollas
yellowish-green disc flower	yellowish-green disc flower
yellowish-white	yellowish-white
yin nature	yin nature
yunnan	yunnan
z ) -erucifoline	z)-erucifoline
z)-erucifoline	z)-erucifoline
zesty salad condiment	zesty salad condiment
zichrini	zichrini
zigzag pattern	zigzag patterns
zone	zones
zone barrier	zone barriers
zoospore	zoospores
zoospores swim	zoospores swim
